The Chipmunk Song	The Chipmunks With David Seville
Smoke Gets In Your Eyes	The Platters
To Know Him, Is To Love Him	The Teddy Bears
Problems	The Everly Brothers
Tom Dooley	The Kingston Trio
One Night	Elvis Presley
Beep Beep	The Playmates
Lonesome Town	Ricky Nelson
It's Only Make Believe	Conway Twitty
A Lover's Question	Clyde McPhatter
I Got Stung	Elvis Presley
Whole Lotta Loving	Fats Domino
Bimbombey	Jimmie Rodgers
Gotta Travel On	Billy Grammer
Love Is All We Need	Tommy Edwards
Queen Of The Hop	Bobby Darin
My Happiness	Connie Francis
Cannonball	Duane Eddy His Twangy Guitar And The Rebels
Lonely Teardrops	Jackie Wilson
Topsy II	Cozy Cole
I'll Wait For You	Frankie Avalon
I Got A Feeling	Ricky Nelson
Poor Boy	The Royaltones
That Old Black Magic	Louis Prima And Keely Smith
Chantilly Lace	Big Bopper
Philadelphia U.S.A.	The Nu Tornados
Donna	Ritchie Valens
Need You	Donnie Owens
It's All In The Game	Tommy Edwards
The World Outside	The Four Coins
Manhattan Spiritual	Reg Owen & His Orchestra
16 Candles	The Crests
Walking Along	The Diamonds
The End	Earl Grant
Peek-A-Boo	The Cadillacs
Love You Most Of All	Sam Cooke
The Teen Commandments	Paul Anka-Geo. Hamilton IV-Johnny Nash
Big Bopper's Wedding	Big Bopper
(All of a Sudden) My Heart Sings	Paul Anka
I'll Remember Tonight	Pat Boone
The Diary	Neil Sedaka
A Letter To An Angel	Jimmy Clanton
C'mon Everybody	Eddie Cochran
Turvy II	Cozy Cole
I Cried A Tear	LaVern Baker
The Mocking Bird	The Four Lads
The Day The Rains Came	Jane Morgan
Call Me	Johnny Mathis
Pussy Cat	The Ames Brothers
Forget Me Not	Kalin Twins
Tea For Two Cha Cha	The Tommy Dorsey Orchestra
Nobody But You	Dee Clark
¿Dònde Està Santa Claus? (Where Is Santa Claus?)	Augie Rios
Sweet Little Rock And Roller	Chuck Berry
The Wedding	June Valli
The All American Boy	Bill Parsons
Jingle Bell Rock	Bobby Helms
Sing Sing Sing	Bernie Lowe Orchestra
Pledging My Love	Roy Hamilton
Cimarron (Roll On)	Billy Vaughn And His Orchestra
Hideaway	The Four Esquires
It's Just About Time	Johnny Cash And The Tennessee Two
Don't Pity Me	Dion & The Belmonts
Rocka-Conga	The Applejacks
There Goes My Heart	Joni James
Stagger Lee	Lloyd Price
Try Me	James Brown And The Famous Flames
Goodbye Baby	Jack Scott
Cinderella	The Four Preps
Come Prima	Tony Dallara
The Day The Rains Came	Raymond Lefevre and His Orchestra
Ten Commandments Of Love	Harvey & The Moonglows
Run Rudolph Run	Chuck Berry
Jealous Heart	Tab Hunter
Come Prima (Koma Preema)	Polly Bergen
Mr. Success	Frank Sinatra
Lucky Ladybug	Billy & Lillie
Love Of My Life	The Everly Brothers
Merry Christmas Baby	Chuck Berry
Mexican Hat Rock	The Applejacks
Teasin'	Quaker City Boys
Mandolins In The Moonlight	Perry Como
Diamond Ring	Jerry Wallace
The Fool And The Angel	Bobby Helms
Seven Minutes In Heaven	Poni-Tails
White Christmas	Bing Crosby
Non Dimenticar (Don't Forget)	Nat King Cole
The Little Drummer Boy	The Harry Simeone Chorale
I Want To Be Happy Cha Cha	Enoch Light & The Light Brigade
Need Your Love	Bobby Freeman
Rock-in Robin	Bobby Day
Dreamy Eyes	Johnny Tillotson
Philadelphia U.S.A.	Art Lund
Joe Joe Gunne	Chuck Berry
Rockhouse (Part 2)	Ray Charles and his Orchestra
Wiggle, Wiggle	The Accents
So Much	Little Anthony And The Imperials
The Reason	The 5 Chanels
Here I Stand	Wade Flemons and the Newcomers
(I Wanna) Dance With The Teacher	The Olympics