Come Softly To Me	The Fleetwoods
Venus	Frankie Avalon
Pink Shoe Laces	Dodie Stevens
I Need Your Love Tonight	Elvis Presley With The Jordanaires
(Now and Then There's) A Fool Such As I	Elvis Presley With The Jordanaires
Never Be Anyone Else But You	Ricky Nelson
Guitar Boogie Shuffle	The Virtues
It's Just A Matter Of Time	Brook Benton
Tragedy	Thomas Wayne With the Delons
It's Late	Ricky Nelson
Tell Him No	Travis & Bob
The Tijuana Jail	The Kingston Trio
The Happy Organ	Dave "Baby" Cortez
Sea Cruise	Frankie Ford
Since I Don't Have You	The Skyliners
Charlie Brown	The Coasters
Turn Me Loose	Fabian
Three Stars	Tommy Dee with Carol Kay and the Teen-Aires
Enchanted	The Platters
Sorry (I Ran All The Way Home)	The Impalas
That's Why (I Love You So)	Jackie Wilson
This Should Go On Forever	Rod Bernard
For A Penny	Pat Boone
Please Mr. Sun	Tommy Edwards
Where Were You (On Our Wedding Day)?	Lloyd Price
It Doesn't Matter Anymore	Buddy Holly
Alvin's Harmonica	David Seville And The Chipmunks
If I Didn't Care	Connie Francis
I've Had It	The Bell Notes
"Yep!"	Duane Eddy His Twangy Guitar And The Rebels
Everybody Likes To Cha Cha Cha	Sam Cooke
Take A Message To Mary	The Everly Brothers
Guess Who	Jesse Belvin
No Other Arms, No Other Lips	The Chordettes
The Hawaiian Wedding Song (Ke Kali Nei Au)	Andy Williams
Poor Jenny	The Everly Brothers
Come To Me	Marv Johnson
Six Nights A Week	The Crests
Almost Grown	Chuck Berry
I Miss You So	Paul Anka
The Morning Side Of The Mountain	Tommy Edwards
Tell Him No	Dean & Marc
Only You	Franck Pourcel's French Fiddles
As Time Goes By	Johnny Nash
Someone	Johnny Mathis
I'm Never Gonna Tell	Jimmie Rodgers
Goodbye Jimmy, Goodbye	Kathy Linden
I Go Ape	Neil Sedaka
Donna	Ritchie Valens
Come Softly To Me	Ronnie Height
Heavenly Lover	Teresa Brewer
Lovey Dovey	Clyde McPhatter
Yea - Yea (Class Cutter)	Dale Hawkins
Peter Gunn	Ray Anthony and His Orchestra
So Fine	The Fiestas
Raw-Hide	Link Wray And The Wraymen
She Say (Oom Dooby Doom)	The Diamonds
I Cried A Tear	LaVern Baker
The Hanging Tree	Marty Robbins
That's My Little Suzie	Ritchie Valens
French Foreign Legion	Frank Sinatra
The Wang Dang Taffy-Apple Tango (Mambo Cha Cha Cha)	Pat Boone
Moonlight Serenade	The Rivieras
Stagger Lee	Lloyd Price
Tomboy	Perry Como
Endlessly	Brook Benton
The Beat	The Rockin R's
Petite Fleur (Little Flower)	Chris Barber's Jazz Band
A Teenager In Love	Dion & The Belmonts
I Still Get A Thrill (Thinking Of You)	Joni James
Kansas City	Wilbert Harrison
Kookie, Kookie (Lend Me Your Comb)	Edward Byrnes & Connie Stevens
The Kissing Tree	Billy Grammer
Who's That Knocking	The Genies
Goodnight Irene	Billy Williams
77 Sunset Strip	The Big Sound Of Don Ralke
The Walls Have Ears	Patti Page
I Need Your Lovin'	Roy Hamilton
Quiet Village	The Exotic Sounds of Martin Denny
Jo-Jo The Dog-Faced Boy	Annette
Bonaparte's Retreat	Billy Grammer
Matilda	Cookie And His Cupcakes
I Think I'm Gonna Kill Myself	Buddy Knox
Star Love	The Playmates
I've Come Of Age	Billy Storm
May You Always	The McGuire Sisters
Lonely For You	Gary Stites
You're So Fine	The Falcons
I Never Felt Like This	Jack Scott
Dream Lover	Bobby Darin
Boom-A-Dip-Dip	Stan Robinson
You Can't Be True Dear	The Mary Kaye Trio
A Touch Of Pink	Jerry Wallace
I Kneel At Your Throne	Joe Medlin
I Waited Too Long	LaVern Baker
Walkin' To Mother's	Ray Anthony and His Orchestra
I Told Myself A Lie	Clyde McPhatter
That's All I Want	Bobby Day
Two Brothers	David Hill
Pipe Dreams	Jimmy Beck & His Orchestra