Hit The Road Jack	Ray Charles and his Orchestra
Runaround Sue	Dion
Bristol Stomp	The Dovells
Crying	Roy Orbison
You Must Have Been A Beautiful Baby	Bobby Darin
Take Good Care Of My Baby	Bobby Vee
Sad Movies (Make Me Cry)	Sue Thompson
Big Bad John	Jimmy Dean
Mexico	Bob Moore and His Orch.
Ya Ya	Lee Dorsey
This Time	Troy Shondell
I Love How You Love Me	The Paris Sisters
Let's Get Together	Hayley Mills and Hayley Mills
The Fly	Chubby Checker
The Way You Look Tonight	The Lettermen
The Mountain's High	Dick and DeeDee
Little Sister	Elvis Presley
Look In My Eyes	The Chantels
Sweets For My Sweet	The Drifters
Don't Blame Me	The Everly Brothers
Bless You	Tony Orlando
(Marie's The Name) His Latest Flame	Elvis Presley
Tower Of Strength	Gene McDaniels
You're The Reason	Bobby Edwards
(He's My) Dreamboat	Connie Francis
Stick Shift	Duals
My True Story	The Jive Five With Joe Rene And Orchestra
So Long Baby	Del Shannon
One Track Mind	Bobby Lewis
(He's) The Great Impostor	The Fleetwoods
Fool #1	Brenda Lee
Foot Stomping - Part 1	The Flares
I Understand (Just How You Feel)	The G-Clefs
Everlovin'	Rick Nelson
Please Mr. Postman	The Marvelettes
Who Put The Bomp (In The Bomp, Bomp, Bomp)	Barry Mann
Without You	Johnny Tillotson
Anybody But Me	Brenda Lee
A Wonder Like You	Rick Nelson
I Really Love You	The Stereos
Big John	The Shirelles
What A Party	Fats Domino
Candy Man	Roy Orbison
Michael	The Highwaymen
Missing You	Ray Peterson
Take Five	The Dave Brubeck Quartet
The Astronaut (Parts 1 & 2)	Jose Jimenez
Hollywood	Connie Francis
It's Gonna Work Out Fine	Ike & Tina Turner
Moon River	Jerry Butler
Movin'	Bill Black's Combo
It's Just A House Without You	Brook Benton
Does Your Chewing Gum Lose It's Flavor (On The Bedpost Over Night)	Lonnie Donegan And His Skiffle Group
Let Me Belong To You	Brian Hyland
Water Boy	Don Shirley Trio
More Money For You And Me	The Four Preps
Big Cold Wind	Pat Boone
Heartaches	The Marcels
Sad Movies (Make Me Cry)	The Lennon Sisters
Just Out Of Reach (Of My Two Open Arms)	Solomon Burke
Don't Get Around Much Anymore	The Belmonts
Bright Lights Big City	Jimmy Reed
Morning After	Mar-Keys
Feel It	Sam Cooke
Human	Tommy Hunt
Your Last Goodbye	Floyd Cramer
Please Don't Go	Ral Donner
Rock-A-Bye Your Baby With A Dixie Melody	Aretha Franklin
It's Your World	Marty Robbins
When We Get Married	The Dreamlovers
Tonight I Won't Be There	Adam Wade
I Apologize	Timi Yuro
Let True Love Begin	Nat King Cole
Berlin Melody	Billy Vaughn And His Orchestra
Young Boy Blues	Ben E. King
I Wanna Thank You	Bobby Rydell
September In The Rain	Dinah Washington
I'll Be Seeing You	Frank Sinatra
You Don't Know What It Means	Jackie Wilson
Back To The Hop	Danny & The Juniors
God, Country And My Baby	Johnny Burnette
Don't Cry No More	Bobby Bland
Rockin' Bicycle	Fats Domino
Tonight	Ferrante & Teicher
Under The Moon Of Love	Curtis Lee
The Bridge Of Love	Joe Dowell
Come September	Billy Vaughn And His Orchestra
Goodbye Cruel World	James Darren
Late Date	The Parkays
Moon River	Henry Mancini And His Orchestra
'Til	The Angels
Muskrat	The Everly Brothers
Broken Heart And A Pillow Filled With Tears	Patti Page
Guilty Of Loving You	Jerry Fuller
Why Not Now	Matt Monro
In The Middle Of A Heartache	Wanda Jackson
For Me And My Gal	Freddy Cannon
Make Believe Wedding	The Castells
Gypsy Woman	The Impressions
Backtrack	Faron Young