Peppermint Twist - Part I	Joey Dee & the Starliters
Can't Help Falling In Love	Elvis Presley With The Jordanaires
The Twist	Chubby Checker
Norman	Sue Thompson
I Know (You Don't Love Me No More)	Barbara George
The Wanderer	Dion
Duke Of Earl	Gene Chandler
Baby It's You	The Shirelles
Break It To Me Gently	Brenda Lee
The Lion Sleeps Tonight	The Tokens
Dear Lady Twist	Gary U.S. Bonds
A Little Bitty Tear	Burl Ives
Town Without Pity	Gene Pitney
When I Fall In Love	The Lettermen
Run To Him	Bobby Vee
Walk On By	Leroy Van Dyke
Irresistible You	Bobby Darin
Cotton Fields	The Highwaymen
Happy Birthday, Sweet Sixteen	Neil Sedaka
Crying In The Rain	The Everly Brothers
Unchain My Heart	Ray Charles and his Orchestra
Shadrack	Brook Benton
Let There Be Drums	Sandy Nelson
If You Gotta Make A Fool Of Somebody	James Ray
Letter Full Of Tears	Gladys Knight And The Pips
Twist-Her	Bill Black's Combo
Do-Re-Mi	Lee Dorsey
She's Everything (I Wanted You To Be)	Ral Donner
Moon River	Henry Mancini And His Orchestra
When The Boy In Your Arms (Is The Boy In Your Heart)	Connie Francis
Dear Ivan	Jimmy Dean
Turn On Your Love Light	Bobby Bland
Smoky Places	The Corsairs Featuring Jay "Bird" Uzzell
I'm Blue (The Gong-Gong Song)	The Ikettes
Multiplication	Bobby Darin
Funny How Time Slips Away	Jimmy Elledge
Tuff	Ace Cannon
Small Sad Sam	Phil McLean
Pocketful Of Miracles	Frank Sinatra
The Greatest Hurt	Jackie Wilson
The Cajun Queen	Jimmy Dean
Go On Home	Patti Page
Let Me In	The Sensations
Poor Fool	Ike & Tina Turner
Goodbye Cruel World	James Darren
Chip Chip	Gene McDaniels
To A Sleeping Beauty	Jimmy Dean
Surfer's Stomp	The Marketts
Rock-A-Hula Baby	Elvis Presley With The Jordanaires
Please Mr. Postman	The Marvelettes
Maria	Roger Williams
Hey! Baby	Bruce Channel
Percolator (Twist)	Billy Joe & The Checkmates
Let's Twist Again	Chubby Checker
There's No Other (Like My Baby)	The Crystals
Chattanooga Choo Choo	Floyd Cramer
Flying Circle	Frank Slay And His Orchestra
My Boomerang Won't Come Back	Charlie Drake
I'll See You In My Dreams	Pat Boone
Happy Jose (Ching-Ching)	Jack Ross
Afrikaan Beat	Bert Kaempfert And His Orchestra
What's So Good About Good-by	The Miracles
Lost Someone	James Brown And The Famous Flames
I Could Have Loved You So Well	Ray Peterson
I Don't Know Why	Linda Scott
Her Royal Majesty	James Darren
Moon River	Jerry Butler
Dreamy Eyes	Johnny Tillotson
It Will Stand	The Showmen
Twistin' The Night Away	Sam Cooke
She's Got You	Patsy Cline
Where Have All The Flowers Gone	The Kingston Trio
Twistin' Postman	The Marvelettes
What's The Reason	Bobby Edwards
There'll Be No Next Time	Jackie Wilson
Lizzie Borden	The Chad Mitchell Trio
Tears From An Angel	Troy Shondell
Cry To Me	Solomon Burke
Midnight In Moscow	Kenny Ball and his Jazzmen
That's My Pa	Sheb Wooley
A Little Too Much	Clarence Henry
Bandit Of My Dreams	Eddie Hodges
Twistin' All Night Long	Danny & The Juniors with Freddy Cannon
He Knows I Love Him Too Much	The Paris Sisters
Oliver Twist	Rod McKuen
Love Is The Sweetest Thing	Saverio Saridis
A Little Bitty Tear	Wanda Jackson
Nite Owl	Dukays
Blue Water Line	The Brothers Four
Midnight	Johnny Gibson
My Melancholy Baby	The Marcels
Teen Queen Of The Week	Freddy Cannon
(Do The New) Continental	The Dovells
Jamie	Eddie Holland
Ecstasy	Ben E. King
Let Me Call You Sweetheart	Timi Yuro
I Surrender, Dear	Aretha Franklin
Let's Go	Floyd Cramer
Tequila Twist	The Champs
Sugar Babe	Buster Brown