I Can't Help Myself (Sugar Pie Honey Bunch)	Four Tops
(I Can't Get No) Satisfaction	The Rolling Stones
Mr. Tambourine Man	The Byrds
Wooly Bully	Sam The Sham and the Pharaohs
Wonderful World	Herman's Hermits
For Your Love	The Yardbirds
Seventh Son	Johnny Rivers
Crying In The Chapel	Elvis Presley With The Jordanaires
Yes, I'm Ready	Barbara Mason
What The World Needs Now Is Love	Jackie DeShannon
Cara, Mia	Jay & The Americans
You Turn Me On (Turn On Song)	Ian Whitcomb And Bluesville
A Walk In The Black Forest	Horst Jankowski
Hush, Hush, Sweet Charlotte	Patti Page
Back In My Arms Again	The Supremes
Laurie (Strange Things Happen)	Dickey Lee
Before And After	Chad & Jeremy
Help Me, Rhonda	The Beach Boys
Last Chance To Turn Around	Gene Pitney
A Little Bit Of Heaven	Ronnie Dove
I've Been Loving You Too Long (To Stop Now)	Otis Redding
Shakin' All Over	The Guess Who
Catch The Wind	Donovan
Oo Wee Baby, I Love You	Fred Hughes
A World Of Our Own	The Seekers
What's New Pussycat?	Tom Jones
(Such An) Easy Question	Elvis Presley With The Jordanaires
Here Comes The Night	Them
Give Us Your Blessings	The Shangri-Las
You Really Know How To Hurt A Guy	Jan & Dean
Voodoo Woman	Bobby Goldsboro
Tonight's The Night	Solomon Burke
Too Many Rivers	Brenda Lee
I'll Keep Holding On	The Marvelettes
This Little Bird	Marianne Faithfull
Just A Little	The Beau Brummels
I Do	The Marvelows
Engine Engine #9	Roger Miller
Do The Boomerang	Jr. Walker & The All Stars
Marie	The Bachelors
Set Me Free	The Kinks
I'm Henry VIII, I Am	Herman's Hermits
I Like It Like That	The Dave Clark Five
Girl Come Running	The 4 Seasons Featuring the "Sound of Frankie Valli"
Nothing Can Stop Me	Gene Chandler
Little Lonely One	Tom Jones
Ticket To Ride	The Beatles
You'll Never Walk Alone	Gerry And The Pacemakers
Sitting In The Park	Billy Stewart
Who's Cheating Who?	Little Milton
Meeting Over Yonder	The Impressions
Sunshine, Lollipops And Rainbows	Lesley Gore
Seein' The Right Love Go Wrong	Jack Jones
I Want Candy	The Strangeloves
It's Just A Little Bit Too Late	Wayne Fontana & The Mindbenders
Theme From "A Summer Place"	The Lettermen
Don't Just Stand There	Patty Duke
And I Love Him	Esther Phillips
When A Boy Falls In Love	Sam Cooke
Baby, I'm Yours	Barbara Lewis
Take Me Back	Little Anthony And The Imperials
Hold Me, Thrill Me, Kiss Me	Mel Carter
(Remember Me) I'm The One Who Loves You	Dean Martin
Summer Sounds	Robert Goulet
It Feels So Right	Elvis Presley With The Jordanaires
Boot-Leg	Booker T. & The MG's
What's He Doing In My World	Eddy Arnold
Watermelon Man	Gloria Lynne
One Monkey Don't Stop No Show	Joe Tex
Temptation 'Bout To Get Me	The Knight Bros.
Nobody Knows What's Goin' On (In My Mind But Me)	The Chiffons
Silver Threads And Golden Needles	Jody Miller
Trains And Boats And Planes	Billy J. Kramer With The Dakotas
He's A Lover	Mary Wells
I Love You So	Bobbi Martin
Ride Your Pony	Lee Dorsey
Darling Take Me Back	Lenny Welch
Operator	Brenda Holloway
I'm A Fool	Dino, Desi & Billy
Save Your Heart For Me	Gary Lewis And The Playboys
No Pity (In The Naked City)	Jackie Wilson
I Can't Work No Longer	Billy Butler & The Chanters
All I Really Want To Do	The Byrds
My Man	Barbra Streisand
Here I Am	Dionne Warwick
All I Really Want To Do	Cher
New Orleans	Eddie Hodges
Soul Sauce (Guacha Guaro)	Cal Tjader
Cast Your Fate To The Wind	Steve Alaimo
Justine	The Righteous Brothers
The First Thing Ev'ry Morning (And The Last Thing Ev'ry Night)	Jimmy Dean
One Step At A Time	Maxine Brown
Forget Domani	Connie Francis
Stop! Look What You're Doing	Carla Thomas
Down In The Boondocks	Billy Joe Royal
I Want You Back Again	The Zombies
Blue Shadows	B.B. King
Follow Me	The Drifters
Forget Domani	Frank Sinatra
Love Me Now	Brook Benton