When A Man Loves A Woman	Percy Sledge
A Groovy Kind Of Love	The Mindbenders
Paint It, Black	The Rolling Stones
Did You Ever Have To Make Up Your Mind?	The Lovin' Spoonful
I Am A Rock	Simon & Garfunkel
Monday, Monday	The Mamas & The Papas
Rainy Day Women #12 & 35	Bob Dylan
It's A Man's Man's Man's World	James Brown And The Famous Flames
Green Grass	Gary Lewis And The Playboys
Strangers In The Night	Frank Sinatra
Love Is Like An Itching In My Heart	The Supremes
Barefootin'	Robert Parker
Sweet Talkin' Guy	The Chiffons
Kicks	Paul Revere & The Raiders Featuring Mark Lindsay
Good Lovin'	The Young Rascals
The Sun Ain't Gonna Shine (Anymore)	The Walker Bros.
Cool Jerk	The Capitols
Oh How Happy	Shades Of Blue
Opus 17 (Don't You Worry 'Bout Me)	The 4 Seasons Featuring the "Sound of Frankie Valli"
Message To Michael	Dionne Warwick
The More I See You	Chris Montez
Come On Let's Go	The McCoys
You Don't Have To Say You Love Me	Dusty Springfield
(I'm A) Road Runner	Jr. Walker & The All Stars
Mama	B.J. Thomas
Double Shot (Of My Baby's Love)	Swingin' Medallions
Sloop John B	The Beach Boys
How Does That Grab You, Darlin'?	Nancy Sinatra
Hold On! I'm A Comin'	Sam & Dave
Don't Bring Me Down	The Animals
Gloria	Shadows Of Knight
Eight Miles High	The Byrds
Girl In Love	The Outsiders
Backstage	Gene Pitney
Red Rubber Ball	The Cyrkle
Let's Start All Over Again	Ronnie Dove
The Ballad Of Irving	Frank Gallop
The "A" Team	SSgt Barry Sadler
I Love You 1000 Times	The Platters
I Love You Drops	Vic Dana
Come Running Back	Dean Martin
Twinkle Toes	Roy Orbison
Dum-De-Da	Bobby Vinton
Ain't Too Proud To Beg	The Temptations
Dirty Water	The Standells
Dedicated Follower Of Fashion	The Kinks
The Last Word In Lonesome Is Me	Eddy Arnold
S.Y.S.L.J.F.M. (The Letter Song)	Joe Tex
It's Over	Jimmie Rodgers
Crying	Jay & The Americans
Hey Joe	The Leaves
Evol-Not Love	The Five Americans
Mame	Bobby Darin
There's No Living Without Your Loving	Peter And Gordon
Take This Heart Of Mine	Marvin Gaye
I Know You Better Than That	Bobby Goldsboro
My Little Red Book	Love
Better Use Your Head	Little Anthony And The Imperials
Peter Rabbit	Dee Jay And The Runaways
Wiederseh'n	Al Martino
Wang Dang Doodle	Ko Ko Taylor
Let Me Be Good To You	Carla Thomas
Break Out	Mitch Ryder And The Detroit Wheels
Let's Go Get Stoned	Ray Charles
Truly Julie's Blues (I'll Be There)	Bob Lind
Popsicle	Jan & Dean
Cloudy Summer Afternoon (Raindrops)	Barry McGuire
Ninety-Nine And A Half (Won't Do)	Wilson Pickett
Take Some Time Out For Love	The Isley Brothers
Batman & His Grandmother	Dickie Goodman
Younger Girl	The Critters
Younger Girl	The Hondells
Solitary Man	Neil Diamond
Oh Yeah	The Shadows Of Knight
Hanky Panky	Tommy James And The Shondells
The Land Of Milk And Honey	The Vogues
Everyday I Have To Cry	The Gentrys
Little Girl	Syndicate Of Sound
Along Comes Mary	The Association
When A Woman Loves A Man	Esther Phillips
Mame	Louis Armstrong
Have I Stayed Too Long	Sonny & Cher
Come And Get Me	Jackie DeShannon
Good Time Charlie	Bobby Bland
Just A Little Misunderstanding	The Contours
Loving You Is Sweeter Than Ever	Four Tops
My Lover's Prayer	Otis Redding
Heart's Desire	Billy Joe Royal
He	The Righteous Brothers
I'll Love You Forever	The Holidays
He Will Break Your Heart	The Righteous Brothers
Think Of Me	Buck Owens and The Buckaroos
Count Down	Dave "Baby" Cortez
River Deep-Mountain High	Ike & Tina Turner Featuring Tina
Don't Touch Me	Jeannie Seely
One Too Many Mornings	Beau Brummels
Come On And See Me	Tammi Terrell
It's An Uphill Climb To The Bottom	Walter Jackson
Neighbor, Neighbor	Jimmy Hughes
The Impossible Dream (The Quest)	Jack Jones