Leaving On A Jet Plane	Peter, Paul & Mary
Someday We'll Be Together	Diana Ross & The Supremes
Down On The Corner/Fortunate Son	Creedence Clearwater Revival
Na Na Hey Hey Kiss Him Goodbye	Steam
Raindrops Keep Fallin' On My Head	B.J. Thomas
Come Together/Something	The Beatles
Yester-Me, Yester-You, Yesterday	Stevie Wonder
Take A Letter Maria	R.B. Greaves
Holly Holy	Neil Diamond
And When I Die	Blood, Sweat & Tears
Eli's Coming	Three Dog Night
Whole Lotta Love	Led Zeppelin
Backfield In Motion	Mel And Tim
La La La (If I Had You)	Bobby Sherman
Midnight Cowboy	Ferrante & Teicher
Cherry Hill Park	Billy Joe Royal
I Want You Back	Jackson 5
Friendship Train	Gladys Knight And The Pips
Wedding Bell Blues	The 5th Dimension
These Eyes	Jr. Walker & The All Stars
Smile A Little Smile For Me	The Flying Machine
Baby, I'm For Real	The Originals
Jam Up Jelly Tight	Tommy Roe
A Brand New Me	Dusty Springfield
Don't Cry Daddy/Rubberneckin'	Elvis Presley
Up On Cripple Creek	The Band
Heaven Knows	The Grass Roots
Evil Woman Don't Play Your Games With Me	CROW
Eleanor Rigby	Aretha Franklin
Going In Circles	The Friends Of Distinction
Venus	The Shocking Blue
Suite: Judy Blue Eyes	Crosby, Stills & Nash
Groovy Grubworm	Harlow Wilcox and the Oakies
Jingle Jangle	The Archies
Cold Turkey	Plastic Ono Band
Ain't It Funky Now (Part 1)	James Brown
Early In The Morning	Vanity Fare
Sunday Mornin'	Oliver
Mind, Body and Soul	The Flaming Ember
She	Tommy James And The Shondells
Kozmic Blues	Janis Joplin
Okie From Muskogee	Merle Haggard And The Strangers
Cupid	Johnny Nash
Don't Let Love Hang You Up	Jerry Butler
I'll Hold Out My Hand	The Clique
Don't Let Him Take Your Love From Me	Four Tops
Wonderful World, Beautiful People	Jimmy Cliff
Winter World Of Love	Engelbert Humperdinck
You Got To Pay The Price	Gloria Taylor
What You Gave Me	Marvin Gaye & Tammi Terrell
On The Dock Of The Bay	The Dells
Blistered/See Ruby Fall	Johnny Cash
Sugar, Sugar	The Archies
Fancy	Bobbie Gentry
Can't Take My Eyes Off You	Nancy Wilson
She Belongs To Me	Rick Nelson
Suspicious Minds	Elvis Presley
Midnight	Dennis Yost And The Classics IV
Try A Little Kindness	Glen Campbell
She Came In Through The Bathroom Window	Joe Cocker
Undun	The Guess Who
Love Will Find A Way	Jackie DeShannon
One Tin Soldier	The Original Caste
Point It Out	Smokey Robinson & The Miracles
Volunteers	Jefferson Airplane
Arizona	Mark Lindsay
Get It From The Bottom	The Steelers
Let's Work Together (Part 1)	Wilbert Harrison
Walkin' In The Rain	Jay & The Americans
Get Rhythm	Johnny Cash
When Julie Comes Around	The Cuff Links
Let A Man Come In And Do The Popcorn (Part Two)	James Brown
Baby Take Me In Your Arms	Jefferson
I'm Tired	Savoy Brown
Turn! Turn! Turn!/To Everything There Is A Season	Judy Collins
I Love You	Otis Leavill
She Lets Her Hair Down (Early In The Morning)	The Tokens
Lady-O	The Turtles
Goin' Out Of My Head/Forget To Remember	Frank Sinatra
I'm So Glad I Fell For You	David Ruffin
No Time	The Guess Who
Look-Ka Py Py	The Meters
Are You Getting Any Sunshine?	Lou Christie
Come Saturday Morning	The Sandpipers
Tonight I'll Say A Prayer	Eydie Gorme
Six White Horses	Tommy Cash
Together	The Illusion
Groovin' (Out On Life)	The Newbeats
I'm Gonna Love You	The Intrigues
To Be Young, Gifted And Black	Nina Simone
Voodoo Woman	Simon Stokes/Nighthawks
Bold Soul Sister	Ike & Tina Turner
How I Miss You Baby	Bobby Womack
Is It Because I'm Black	Syl Johnson
Love Bones	Johnnie Taylor
It's Been A Long Time	Betty Everett
Alice's Rock & Roll Restaurant	Arlo Guthrie
Mr. Limousine Driver	Grand Funk Railroad
Too Many Cooks (Spoil The Soup)	100 Proof Aged in Soul
He Ain't Heavy, He's My Brother	The Hollies