How Can You Mend A Broken Heart	Bee Gees
Indian Reservation (The Lament Of The Cherokee Reservation Indian)	The Raiders
You've Got A Friend	James Taylor
Mr. Big Stuff	Jean Knight
Draggin' The Line	Tommy James
Take Me Home, Country Roads	John Denver
It's Too Late/I Feel The Earth Move	Carole King
Beginnings/Colour My World	Chicago
What The World Needs Now Is Love/Abraham, Martin and John	Tom Clay
Mercy, Mercy Me (The Ecology)	Marvin Gaye
Don't Pull Your Love	Hamilton, Joe Frank & Reynolds
Bring The Boys Home	Freda Payne
Never Ending Song Of Love	Delaney & Bonnie & Friends
Sooner Or Later	The Grass Roots
Signs	Five Man Electrical Band
Hot Pants (She Got To Use What She Got To Get What She Wants) (Pt. 1)	James Brown
Rings	Cymarron
Sweet Hitch-Hiker	Creedence Clearwater Revival
Love The One You're With	The Isley Brothers
Liar	Three Dog Night
Here Comes That Rainy Day Feeling Again	The Fortunes
Double Barrel	Dave & Ansil Collins
Riders On The Storm	The Doors
Maybe Tomorrow	Jackson 5
Smiling Faces Sometimes	The Undisputed Truth
Treat Her Like A Lady	Cornelius Brothers & Sister Rose
Get It On	Chase
I Don't Want To Do Wrong	Gladys Knight And The Pips
Spanish Harlem	Aretha Franklin
Whatcha See Is Whatcha Get	The Dramatics
You've Got A Friend	Roberta Flack & Donny Hathaway
Moon Shadow	Cat Stevens
If Not For You	Olivia Newton-John
Funky Nassau-Part I	The Beginning Of The End
That's The Way I've Always Heard It Should Be	Carly Simon
She's Not Just Another Woman	The 8th Day
I Just Want To Celebrate	Rare Earth
Summer Sand	Dawn
Won't Get Fooled Again	The Who
Resurrection Shuffle	Ashton, Gardner & Dyke
Watching The River Flow	Bob Dylan
Mighty Clouds Of Joy	B.J. Thomas
Chicago	Graham Nash
I'm Leavin'	Elvis Presley
Mother Freedom	Bread
She Didn't Do Magic/I'm The Only One	Lobo
Love Means (You Never Have To Say You're Sorry)	Sounds Of Sunshine
Ain't No Sunshine	Bill Withers
Wild Horses	The Rolling Stones
Tired Of Being Alone	Al Green
I Likes To Do It	The People's Choice
Rainy Jane	Davy Jones
He's So Fine	Jody Miller
It's Summer	The Temptations
Go Down Gamblin'	Blood, Sweat & Tears
Crazy About The La La La	Smokey Robinson & The Miracles
Where You Lead	Barbra Streisand
Ride With Me	Steppenwolf
I Hear Those Church Bells Ringing	Dusk
Saturday Morning Confusion	Bobby Russell
I'm A Believer	Neil Diamond
Maggie	Redbone
Hey! Love/Over And Over	The Delfonics
Chirpy Chirpy Cheep Cheep	Mac And Katie Kissoon
Maggie May/Reason To Believe	Rod Stewart
Do You Know What I Mean	Lee Michaels
Change Partners	Stephen Stills
Stick-Up	The Honey Cone
The Last Time I Saw Her	Glen Campbell
He's Gonna Step On You Again	John Kongos
Mozart Symphony No. 40 In G Minor K.550, 1st Movement	Waldo De Los Rios
Wedding Song (There Is Love)	Paul Stookey
Come Back Home	Bobby Goldsboro
Where Evil Grows	The Poppy Family
One-Way Ticket	Tyrone Davis
We Are Neighbors	The Chi-lites
Like An Open Door	The Fuzz
Hill Where The Lord Hides	Chuck Mangione
Indian Summer	Audience
You're The One For Me	Joe Simon
All Day Music	War
I Ain't Got Time Anymore	The Glass Bottle
I've Found Someone Of My Own	The Free Movement
Gonna Be Alright Now	Gayle McCormick
K-Jee	The Nite-Liters
It's The Real Thing - Pt. I	The Electric Express
Take Me Girl, I'm Ready	Jr. Walker & The All Stars
The Story In Your Eyes	The Moody Blues
Go Away Little Girl	Donny Osmond
Top Forty	Sha Na Na
Them Changes	Buddy Miles & The Freedom Express
It's About Time	The Dillards
Crazy Love	Helen Reddy
We Got A Dream	Ocean
Love Me	The Impressions
Amanda	Dionne Warwicke
You've Got To Earn It	The Staple Singers
Slipped, Tripped And Fell In Love	Clarence Carter
Good Enough To Be Your Wife	Jeannie C. Riley
California On My Mind	Morning Mist