I Can See Clearly Now	Johnny Nash
Nights In White Satin	The Moody Blues
I'd Love You To Want Me	Lobo
Freddie's Dead (Theme From "Superfly")	Curtis Mayfield
I'll Be Around	The Spinners
Garden Party	Rick Nelson And The Stone Canyon Band
My Ding-A-Ling	Chuck Berry
I Am Woman	Helen Reddy
Convention '72	The Delegates
Witchy Woman	Eagles
Listen To The Music	The Doobie Brothers
If I Could Reach You	The 5th Dimension
Papa Was A Rollin' Stone	The Temptations
Burning Love	Elvis Presley
Good Time Charlie's Got The Blues	Danny O'Keefe
Summer Breeze	Seals & Crofts
Ben	Michael Jackson
Thunder And Lightning	Chi Coltrane
Starting All Over Again	Mel And Tim
If You Don't Know Me By Now	Harold Melvin And The Blue Notes
You Ought To Be With Me	Al Green
I Believe In Music	Gallery
Spaceman	Nilsson
Ventura Highway	America
I'm Stone In Love With You	The Stylistics
Elected	Alice Cooper
It Never Rains In Southern California	Albert Hammond
American City Suite	Cashman & West
Loving You Just Crossed My Mind	Sam Neely
Operator (That's Not the Way it Feels)	Jim Croce
Funny Face	Donna Fargo
Crazy Horses	The Osmonds
Something's Wrong With Me	Austin Roberts
Don't Do It	The Band
Rock 'N Roll Soul	Grand Funk Railroad
Clair	Gilbert O'Sullivan
All The Young Dudes	Mott The Hoople
Rockin' Pneumonia - Boogie Woogie Flu	Johnny Rivers
Why/Lonely Boy	Donny Osmond
Use Me	Bill Withers
Everybody Plays The Fool	The Main Ingredient
Corner Of The Sky	Jackson 5
The City Of New Orleans	Arlo Guthrie
Dialogue (Part I & II)	Chicago
Tight Rope	Leon Russell
That's How Love Goes	Jermaine Jackson
Don't Ever Be Lonely (A Poor Little Fool Like Me)	Cornelius Brothers & Sister Rose
Me And Mrs. Jones	Billy Paul
Sunny Days	Lighthouse
Can't You Hear The Song?	Wayne Newton
Let It Rain	Eric Clapton
Poor Boy	Casey Kelly
Woman Don't Go Astray	King Floyd
Baby Sitter	Betty Wright
Sweet Surrender	Bread
Theme From The Men	Isaac Hayes
Man Sized Job	Denise LaSalle
Why Can't We Be Lovers	Holland-Dozier
So Long Dixie	Blood, Sweat & Tears
I Love You More Than You'll Ever Know	Donny Hathaway
Work To Do	The Isley Brothers
Living In The Past	Jethro Tull
No	Bulldog
I Didn't Know I Loved You (Till I Saw You Rock And Roll)	Gary Glitter
If You Can Beat Me Rockin' (You Can Have My Chair)	Laura Lee
If You Let Me	Eddie Kendricks
What Am I Crying For?	Dennis Yost And The Classics IV
We Can Make It Together	Steve & Eydie Featuring The Osmonds
Wedding Song (There Is Love)	Petula Clark
Lies	J.J. Cale
Keeper Of The Castle	Four Tops
In Heaven There Is No Beer	Clean Living
Long Dark Road	The Hollies
Special Someone	The Heywoods
Down To The Nightclub	Tower Of Power
One Night Affair	Jerry Butler
Dancing In The Moonlight	King Harvest
Sunday Morning Sunshine	Harry Chapin
I Found My Dad	Joe Simon
Guilty	Al Green
992 Arguments	The O'Jays
I'll Make You Music	Beverly Bremers
And You And I (Part II)	Yes
Good Time Sally	Rare Earth
Walk On Water	Neil Diamond
Together Alone	Melanie
I Guess I'll Miss The Man	The Supremes
Lovin' You, Lovin' Me	Candi Staton
Your Mama Don't Dance	Kenny Loggins & Jim Messina
Annabelle	Daniel Boone
Misty Blue	Joe Simon
The People Tree	Sammy Davis, Jr. with The Mike Curb Congregation
I Got A Thing About You Baby	Billy Lee Riley
Roberta	Bones
Celebration	Tommy James
Do Ya	The Move
Suite: Man And Woman	Tony Cole
Smoke Gets In Your Eyes	Blue Haze
You Turn Me On, I'm A Radio	Joni Mitchell
Mama Told Me Not To Come	Wilson Pickett