The Night The Lights Went Out In Georgia	Vicki Lawrence
Neither One Of Us (Wants To Be The First To Say Goodbye)	Gladys Knight And The Pips
Killing Me Softly With His Song	Roberta Flack
Ain't No Woman (Like The One I've Got)	Four Tops
Break Up To Make Up	The Stylistics
Tie A Yellow Ribbon Round The Ole Oak Tree	Dawn Featuring Tony Orlando
Sing	Carpenters
Danny's Song	Anne Murray
Also Sprach Zarathustra (2001)	Deodato
The Cisco Kid	War
Call Me (Come Back Home)	Al Green
Love Train	The O'Jays
Last Song	Edward Bear
Masterpiece	The Temptations
Space Oddity	David Bowie
Stir It Up	Johnny Nash
Dead Skunk	Loudon Wainwright III
The Twelfth Of Never	Donny Osmond
Dueling Banjos	Deliverance/Eric Weissberg & Steve Mandell
Little Willy	The Sweet
The Cover Of "Rolling Stone"	Dr. Hook And The Medicine Show
Hummingbird	Seals & Crofts
Peaceful	Helen Reddy
Stuck In The Middle With You	Stealers Wheel
You Are The Sunshine Of My Life	Stevie Wonder
Aubrey	Bread
Could It Be I'm Falling In Love	The Spinners
Walk On The Wild Side	Lou Reed
Drift Away	Dobie Gray
I'm Just A Singer (In A Rock And Roll Band)	The Moody Blues
Wildflower	Skylark
Cook With Honey	Judy Collins
Daddy's Home	Jermaine Jackson
A Letter To Myself	The Chi-lites
Daisy A Day	Jud Strunk
Master Of Eyes (The Deepness Of Your Eyes)	Aretha Franklin
One Man Band (Plays All Alone)	Ronnie Dyson
Bitter Bad	Melanie
Reeling In The Years	Steely Dan
Out Of The Question	Gilbert O'Sullivan
Superman	Donna Fargo
Step By Step	Joe Simon
Hallelujah Day	Jackson 5
Oh La De Da	The Staple Singers
Pinball Wizard/See Me, Feel Me	The New Seekers
Kissing My Love	Bill Withers
Funky Worm	Ohio Players
Big City Miss Ruth Ann	Gallery
"Cherry Cherry" from Hot August Night	Neil Diamond
Do You Want To Dance?	Bette Midler
I'm Doin' Fine Now	New York City
Down And Out In New York City	James Brown
One Less Set Of Footsteps	Jim Croce
Cindy Incidentally	Faces
Hocus Pocus	Focus
Blue Suede Shoes	Johnny Rivers
Good Morning Heartache	Diana Ross
Who Was It?	Hurricane Smith
Frankenstein	Edgar Winter Group
The Right Thing To Do	Carly Simon
Armed And Extremely Dangerous	First Choice
Thinking Of You	Loggins & Messina
If You Gotta Break Another Heart	Albert Hammond
Let Your Yeah Be Yeah	Brownsville Station
I Knew Jesus (Before He Was A Star)	Glen Campbell
Let's Pretend	Raspberries
Yesterday I Had The Blues	Harold Melvin And The Blue Notes
Playground In My Mind	Clint Holmes
Hello Hurray	Alice Cooper
Teddy Bear Song	Barbara Fairchild
Hearts Of Stone	The Blue Ridge Rangers
Gudbuy T' Jane	Slade
Pardon Me Sir	Joe Cocker
Across 110th Street	Bobby Womack & Peace
The Lord Knows I'm Drinking	Cal Smith
If We Try	Don McLean
Daniel	Elton John
I Can Understand It	The New Birth
Pillow Talk	Sylvia (r&b)
Mama Was A Rock And Roll Singer, Papa Used To Write All Her Songs Part 1	Sonny & Cher
Drinking Wine Spo-dee O'dee	Jerry Lee Lewis
Sail On Sailor	The Beach Boys
Back When My Hair Was Short	Gunhill Road
Dancing To Your Music	Archie Bell & The Drells
It Sure Took A Long, Long Time	Lobo
Nobody Wins	Brenda Lee
Leaving Me	The Independents
Last Tango In Paris	Herb Alpert & The Tijuana Brass
River Road	Uncle Dog
Will It Go Round In Circles	Billy Preston
Give It To Me	The J. Geils Band
Delta Queen	Don Fardon
Always	Luther Ingram
Saw A New Morning	Bee Gees
People Are Changin'	Timmy Thomas
If I Could Only Be Sure	Nolan Porter
Am I Black Enough For You	Billy Paul
Wish That I Could Talk To You	The Sylvers
Only Love	Bill Quateman
Why Me	Kris Kristofferson