TSOP (The Sound Of Philadelphia)	MFSB Featuring The Three Degrees
Bennie And The Jets	Elton John
Best Thing That Ever Happened To Me	Gladys Knight And The Pips
The Loco-Motion	Grand Funk
Oh My My	Ringo Starr
Hooked On A Feeling	Blue Swede
Come And Get Your Love	Redbone
Dancing Machine	Jackson 5
I'll Have To Say I Love You In A Song	Jim Croce
Lookin' For A Love	Bobby Womack
Just Don't Want To Be Lonely	The Main Ingredient
Tubular Bells	Mike Oldfield
The Show Must Go On	Three Dog Night
Sunshine On My Shoulders	John Denver
Keep On Singing	Helen Reddy
(i've Been) Searchin' So Long	Chicago
The Lord's Prayer	Sister Janet Mead
The Entertainer	Marvin Hamlisch/"The Sting"
The Streak	Ray Stevens
My Mistake (Was To Love You)	Diana Ross & Marvin Gaye
You Make Me Feel Brand New	The Stylistics
Midnight At The Oasis	Maria Muldaur
Let It Ride	Bachman-Turner Overdrive
Seasons In The Sun	Terry Jacks
A Very Special Love Song	Charlie Rich
Mockingbird	Carly Simon & James Taylor
Touch A Hand, Make A Friend	The Staple Singers
Tell Me A Lie	Sami Jo
Help Me	Joni Mitchell
Oh Very Young	Cat Stevens
I'm A Train	Albert Hammond
The Payback - Part I	James Brown
Don't You Worry 'Bout A Thing	Stevie Wonder
Outside Woman	Bloodstone
I Won't Last A Day Without You	Carpenters
Piano Man	Billy Joel
Thanks For Saving My Life	Billy Paul
Jet	Paul McCartney And Wings
Eres Tu (Touch The Wind)	Mocedades
Mighty Mighty	Earth, Wind & Fire
Band On The Run	Paul McCartney And Wings
Dark Lady	Cher
Let's Get Married	Al Green
Heavenly	The Temptations
For The Love Of Money	The O'Jays
I'm In Love	Aretha Franklin
Star Baby	The Guess Who
Mighty Love - Pt. 1	The Spinners
Dance With The Devil	Cozy Powell
Jungle Boogie	Kool & The Gang
Boogie Down	Eddie Kendricks
Rock Around The Clock	Bill Haley And His Comets
The Way We Were	Barbra Streisand
Standing At The End Of The Line	Lobo
There Won't Be Anymore	Charlie Rich
My Girl Bill	Jim Stafford
Keep It In The Family	Leon Haywood
Rock On	David Essex
Chameleon	Herbie Hancock
Love's Theme	Love Unlimited Orchestra
Summer Breeze (Part 1)	The Isley Brothers
If You Love Me (let Me Know)	Olivia Newton-John
Sundown	Gordon Lightfoot
One Hell Of A Woman	Mac Davis
Werewolf	Five Man Electrical Band
Daybreak	Nilsson
I Am What I Am	Lois Fletcher
Touch And Go	Al Wilson
Happiness Is Me And You	Gilbert O'Sullivan
A Dream Goes On Forever	Todd Rundgren
You Won't See Me	Anne Murray
I've Got A Thing About You Baby/Take Good Care Of Her	Elvis Presley
Satisfaction Guaranteed (Or Take Your Love Back)	Harold Melvin And The Blue Notes
Once You Understand	Think
All In Love Is Fair	Barbra Streisand
Hollywood Swinging	Kool & The Gang
No Charge	Melba Montgomery
Billy, Don't Be A Hero	Bo Donaldson And The Heywoods
The Same Love That Made Me Laugh	Bill Withers
Under The Influence Of Love	Love Unlimited
Power Of Love	Martha Reeves
La Grange	ZZ Top
Silver Threads And Golden Needles	Linda Ronstadt
It Only Hurts When I Try To Smile	Dawn Featuring Tony Orlando
Another Park, Another Sunday	The Doobie Brothers
Put A Little Love Away	The Emotions
Who Is He And What Is He To You	Creative Source
If I Were A Carpenter...	Leon Russell
(I'm A) YoYo Man	Rick Cunha
If You Wanna Get To Heaven	Ozark Mountain Daredevils
Bad, Bad Leroy Brown	Frank Sinatra
If It Feels Good, Do It	Ian Lloyd & Stories
Time Will Tell	Tower Of Power
Teenage Love Affair	Rick Derringer
Loving You	Johnny Nash
The Air That I Breathe	The Hollies
Help Yourself	The Undisputed Truth
Scratch	The Crusaders
Billy - Don't Be A Hero	Paper Lace
Rhapsody In White	Love Unlimited Orchestra