Arthur's Theme (Best That You Can Do)	Christopher Cross
Endless Love	Diana Ross & Lionel Richie
Start Me Up	The Rolling Stones
For Your Eyes Only	Sheena Easton
Step By Step	Eddie Rabbitt
Private Eyes	Daryl Hall John Oates
Stop Draggin' My Heart Around	Stevie Nicks With Tom Petty And The Heartbreakers
Who's Crying Now	Journey
Hard To Say	Dan Fogelberg
The Night Owls	Little River Band
Urgent	Foreigner
I've Done Everything For You	Rick Springfield
Hold On Tight	Electric Light Orchestra
Tryin' To Live My Life Without You	Bob Seger
Share Your Love With Me	Kenny Rogers
When She Was My Girl	Four Tops
Super Freak (Part I)	Rick James
I Could Never Miss You (More Than I Do)	Lulu
We're In This Love Together	Al Jarreau
Say Goodbye To Hollywood	Billy Joel
Just Once	Quincy Jones Featuring James Ingram
The Theme From Hill Street Blues	Mike Post featuring Larry Carlton
Here I Am (Just When I Thought I Was Over You)	Air Supply
She's A Bad Mama Jama (She's Built, She's Stacked)	Carl Carlton
Waiting For A Girl Like You	Foreigner
Queen Of Hearts	Juice Newton
Oh No	Commodores
Every Little Thing She Does Is Magic	The Police
Atlanta Lady (Something About Your Love)	Marty Balin
The Voice	The Moody Blues
Physical	Olivia Newton-John
He's A Liar	Bee Gees
Alien	Atlanta Rhythm Section
The Beach Boys Medley	The Beach Boys
(There's) No Gettin' Over Me	Ronnie Milsap
Lady (You Bring Me Up)	Commodores
Sausalito Summernight	Diesel
The Old Songs	Barry Manilow
In The Dark	Billy Squier
Burnin' For You	Blue Oyster Cult
Our Lips Are Sealed	Go-Go's
You Saved My Soul	Burton Cummings
Heavy Metal (Takin' A Ride)	Don Felder
Working In The Coal Mine	Devo
Slow Hand	The Pointer Sisters
General Hospi-tale	The Afternoon Delights
In Your Letter	REO Speedwagon
Promises In The Dark	Pat Benatar
Breaking Away	Balance
My Girl (Gone, Gone, Gone)	Chilliwack
Theme From "Greatest American Hero" (Believe It or Not)	Joey Scarbury
Draw Of The Cards	Kim Carnes
Love All The Hurt Away	Aretha Franklin And George Benson
No Reply At All	Genesis
More Stars	More Stars On 45
Why Do Fools Fall In Love	Diana Ross
Steal The Night	Stevie Woods
Let's Groove	Earth, Wind & Fire
It's All I Can Do	Anne Murray
Stay Awake	Ronnie Laws
Young Turks	Rod Stewart
I Want You, I Need You	Chris Christian
Take Me Now	David Gates
Jessie's Girl	Rick Springfield
Never Too Much	Luther Vandross
Some Days Are Diamonds (Some Days Are Stone)	John Denver
Take My Heart (You Can Have It If You Want It)	Kool & The Gang
One More Night	Streek
Still	John Schneider
When She Dances	Joey Scarbury
A Lucky Guy	Rickie Lee Jones
(Want You) Back In My Life Again	Carpenters
Wired For Sound	Cliff Richard
Bet Your Heart On Me	Johnny Lee
Magic Power	Triumph
Fire In The Sky	The Dirt Band
Leila	ZZ Top
Poor Man's Son	Survivor
The Sweetest Thing (I've Ever Known)	Juice Newton
Harden My Heart	Quarterflash
I'm In Love	Evelyn King
Run To Me	Savoy Brown
Feels So Right	Alabama
Fire And Ice	Pat Benatar
Cool Love	Pablo Cruise
Snake Eyes	The Alan Parsons Project
The Breakup Song (They Don't Write 'Em)	Greg Kihn Band
Slip Away	Pablo Cruise
Back To The 60's	Tight Fit
I Surrender	Arlan Day
Really Wanna Know You	Gary Wright
Backfired	Debbie Harry
Silly	Deniece Williams
Square Biz	Teena Marie
Aiming At Your Heart	The Temptations
That Old Song	Ray Parker Jr. & Raydio
Straight From The Heart	The Allman Brothers Band
Chloe	Elton John
Let's Put The Fun Back In Rock N Roll	Freddy Cannon & The Belmonts
You Could Take My Heart Away	Silver Condor