When I See You Smile	Bad English
Listen To Your Heart	Roxette
Cover Girl	New Kids On The Block
Blame It On The Rain	Milli Vanilli
(It's Just) The Way That You Love Me	Paula Abdul
Love Shack	The B-52s
Miss You Much	Janet Jackson
Sowing The Seeds Of Love	Tears For Fears
Didn't I (Blow Your Mind)	New Kids On The Block
Rock Wit'cha	Bobby Brown
Angelia	Richard Marx
Love In An Elevator	Aerosmith
We Didn't Start The Fire	Billy Joel
Poison	Alice Cooper
Bust A Move	Young M.C.
Back To Life	Soul II Soul
Get On Your Feet	Gloria Estefan
Don't Know Much	Linda Ronstadt (Featuring Aaron Neville)
Don't Close Your Eyes	KIX
Dr. Feelgood	Motley Crue
Leave A Light On	Belinda Carlisle
Call It Love	Poco
Sunshine	Dino
Don't Shut Me Out	Kevin Paige
Healing Hands	Elton John
Living In Sin	Bon Jovi
The Best	Tina Turner
Me So Horny	The 2 Live Crew
With Every Beat Of My Heart	Taylor Dayne
It's No Crime	Babyface
When I Looked At Him	Expose
Sugar Daddy	Thompson Twins
Another Day In Paradise	Phil Collins
Love Song	The Cure
Don't Make Me Over	Sybil
The Last Worthless Evening	Don Henley
Pump Up The Jam	Technotronic Featuring Felly
Licence To Chill	Billy Ocean
Girl I'm Gonna Miss You	Milli Vanilli
Love Song	Tesla
The Way To Your Heart	Soulsister
Just Like Jesse James	Cher
The Angel Song	Great White
Just Between You And Me	Lou Gramm
Everything	Jody Watley
Heaven	Warrant
If I Could Turn Back Time	Cher
Don't Ask Me Why	Eurythmics
Rhythm Nation	Janet Jackson
The Arms Of Orion	Prince With Sheena Easton
My Heart Skips A Beat	The Cover Girls
Cherish	Madonna
I Live By The Groove	Paul Carrack
Talk To Myself	Christopher Williams
Oh Father	Madonna
How Am I Supposed To Live Without You	Michael Bolton
Mixed Emotions	The Rolling Stones
Rock And A Hard Place	The Rolling Stones
Sold Me Down The River	The Alarm
Swing The Mood	Jive Bunny & The Mastermixers
Girl I Am Searching For You	Stevie B
I'm A Believer	Giant
When The Night Comes	Joe Cocker
Free Fallin'	Tom Petty
Baby Come To Me	Regina Belle
What About Me	Moving Pictures
I Want You	Shana
Fool For Your Loving	Whitesnake
New Thing	Enuff Z'Nuff
If You Leave Me Now	Jaya
(You're My One And Only) True Love	Seduction
French Kiss	Lil Louis
Radar Love	White Lion
18 And Life	Skid Row
Glamour Boys	Living Colour
It's Not Enough	Starship
Was It Nothing At All	Michael Damian
Two To Make It Right	Seduction
Right Here Waiting	Richard Marx
Heat Of The Moment	After 7
I Love The Bass	Bardeux
This One's For The Children	New Kids On The Block
Touch Me Tonight	Shooting Star
Realistic	Shirley Lewis
I'm Not The Man I Used To Be	Fine Young Cannibals
I Think I Can Beat Mike Tyson	D.J. Jazzy Jeff & The Fresh Prince
Bring It All Back	Grayson Hugh
Over And Over	Pajama Party
You Are My Everything	Surface
Crossroads	Tracy Chapman
Back To The Bullet	Saraya
Hold On	Donny Osmond
Big Talk	Warrant
The Same Love	The Jets
Let Go	Sharon Bryant
Angel Eyes	The Jeff Healey Band
Name And Number	Big Noise
No Souvenirs	Melissa Etheridge
Cold Hearted	Paula Abdul
I Feel The Earth Move	Martika