How Am I Supposed To Live Without You	Michael Bolton
Pump Up The Jam	Technotronic Featuring Felly
Downtown Train	Rod Stewart
Everything	Jody Watley
Two To Make It Right	Seduction
Just Between You And Me	Lou Gramm
Free Fallin'	Tom Petty
Opposites Attract	Paula Abdul (Duet With The Wild Pair)
I Remember You	Skid Row
Another Day In Paradise	Phil Collins
Janie's Got A Gun	Aerosmith
Love Song	Tesla
Peace In Our Time	Eddie Money
When The Night Comes	Joe Cocker
What Kind Of Man Would I Be?	Chicago
Tender Lover	Babyface
Rhythm Nation	Janet Jackson
I'll Be Good To You	Quincy Jones Featuring Ray Charles & Chaka Khan
Tell Me Why	Expose
Dangerous	Roxette
Don't Know Much	Linda Ronstadt (Featuring Aaron Neville)
All Or Nothing	Milli Vanilli
Here We Are	Gloria Estefan
Swing The Mood	Jive Bunny & The Mastermixers
Was It Nothing At All	Michael Damian
We Can't Go Wrong	The Cover Girls
Kickstart My Heart	Motley Crue
Price Of Love	Bad English
Back To Life	Soul II Soul
Escapade	Janet Jackson
With Every Beat Of My Heart	Taylor Dayne
No More Lies	Michel'le
Just Like Jesse James	Cher
Roam	The B-52s
This One's For The Children	New Kids On The Block
I Go To Extremes	Billy Joel
C'mon And Get My Love	D-Mob Introducing Cathy Dennis
We Didn't Start The Fire	Billy Joel
Woman In Chains	Tears For Fears
Too Late To Say Goodbye	Richard Marx
Principal's Office	Young M.C.
Blame It On The Rain	Milli Vanilli
Sometimes She Cries	Warrant
I Want You	Shana
Bust A Move	Young M.C.
Nothin' To Hide	Poco
If You Leave Me Now	Jaya
Here And Now	Luther Vandross
Love Shack	The B-52s
No Myth	Michael Penn
Personal Jesus	Depeche Mode
Electric Boogie	Marcia Griffiths
I Will Survive	SaFire
Black Velvet	Alannah Myles
Love Will Lead You Back	Taylor Dayne
Going Home	Kenny G
Me So Horny	The 2 Live Crew
Don't Close Your Eyes	KIX
Just A Friend	Biz Markie
The Deeper The Love	Whitesnake
Never 2 Much Of U	Dino
Wait For You	Bonham
Don't Make Me Over	Sybil
A Girl Like You	The Smithereens
Anything I Want	Kevin Paige
Sacrifice	Elton John
When I See You Smile	Bad English
Living In Sin	Bon Jovi
Everything You Do (You're Sexing Me)	Fiona (Duet With Kip Winger)
Oh Father	Madonna
Summer Rain	Belinda Carlisle
Whole Wide World (From "True Love")	A'me Lorain
Don't Take It Personal	Jermaine Jackson
All Nite	Entouch Featuring Keith Sweat
Steamy Windows	Tina Turner
House Of Fire	Alice Cooper
Over And Over	Pajama Party
(It's Just) The Way That You Love Me	Paula Abdul
The Angel Song	Great White
Dirty Deeds	Joan Jett
Rock And A Hard Place	The Rolling Stones
Walk On By	Sybil
Real Love	Skyy
The Last Worthless Evening	Don Henley
Timeless Love (From "Shocker")	Saraya
Get Up! (Before The Night Is Over)	Technotronic
If U Were Mine	The U-Krew
Fool For Your Loving	Whitesnake
Let Love Rule	Lenny Kravitz
There's A Party Going On	Yvonne
Fly High Michelle	Enuff Z'Nuff
Angelia	Richard Marx
Don't Shut Me Out	Kevin Paige
Right And Hype	Abstrac'
Figure Of Eight	Paul McCartney
Leave A Light On	Belinda Carlisle
Pretending	Eric Clapton
Heart	Neneh Cherry
Poison	Alice Cooper
Hide Your Heart	KISS