End Of The Road (From "Boomerang")	Boyz II Men
How Do You Talk To An Angel	The Heights
I'd Die Without You (From "Boomerang")	P.M. Dawn
Sometimes Love Just Ain't Enough	Patty Smyth
Erotica	Madonna
Jump Around	House Of Pain
Rhythm Is A Dancer	Snap!
Rump Shaker	Wreckx-N-Effect
Real Love	Mary J. Blige
What About Your Friends	TLC
Free Your Mind	En Vogue
If I Ever Fall In Love	Shai
Would I Lie To You?	Charles & Eddie
People Everyday	Arrested Development
Have You Ever Needed Someone So Bad	Def Leppard
She's Playing Hard To Get	Hi-Five
Walking On Broken Glass	Annie Lennox
Forever Love (From "Mo' Money")	Color Me Badd
When I Look Into Your Eyes	Firehouse
Good Enough	Bobby Brown
Layla	Eric Clapton
Please Don't Go	K.W.S.
Love Is On The Way	Saigon Kick
Humpin' Around	Bobby Brown
Baby-Baby-Baby	TLC
Someone To Hold	Trey Lorenz
Do You Believe In Us	Jon Secada
Just Another Day	Jon Secada
Back To The Hotel	N2Deep
I Will Be Here For You	Michael W. Smith
Do I Have To Say The Words?	Bryan Adams
All I Want	Toad The Wet Sprocket
I Wanna Love You (From "Class Act")	Jade
To Love Somebody	Michael Bolton
Keep The Faith	Bon Jovi
The One	Elton John
Where You Goin' Now	Damn Yankees
How About That	Bad Company
Always The Last To Know	Del Amitri
November Rain	Guns N' Roses
Saving Forever For You (From "Beverly Hills, 90210")	Shanice
Giving Him Something He Can Feel	En Vogue
Move This	Technotronic Featuring Ya Kid K
Little Miss Can't Be Wrong	Spin Doctors
Flex	Mad Cobra
Restless Heart	Peter Cetera
Right Now	Al B. Sure!
Stay	Shakespear's Sister
Life Is A Highway	Tom Cochrane
My Name Is Prince	Prince And The New Power Generation
Chains Around My Heart	Richard Marx
Work To Do	Vanessa Williams
Not Enough Time	INXS
Slow Dance (Hey Mr. DJ)	R. Kelly & Public Announcement
Slow And Sexy	Shabba Ranks (Featuring Johnny Gill)
You Lied To Me	Cathy Dennis
I Wish The Phone Would Ring	Expose
Am I The Same Girl	Swing Out Sister
You Gotta Believe	Marky Mark & The Funky Bunch
Digging In The Dirt	Peter Gabriel
Constant Craving	k.d. lang
The Last Song	Elton John
Nothing Broken But My Heart	Celine Dion
Crossover	EPMD
Drive	R.E.M.
How Do You Do!	Roxette
Jump!	The Movement
Jesus He Knows Me	Genesis
Sweet November	Troop
The Hitman	AB Logic
Here It Comes	MC Serch
Alone With You	Tevin Campbell
This Used To Be My Playground	Madonna
Johnny Have You Seen Her?	The Rembrandts
The Message	Sofia Shinas
I Missed The Bus	Kris Kross
Who's Gonna Ride Your Wild Horses	U2
Groovin' In The Midnight	Maxi Priest
Divine Thing	The Soup Dragons
Where Does That Leave Love	George LaMond
Sesame's Treet	Smart E's
Could've Been Me	Billy Ray Cyrus
Never A Time	Genesis
Faithful	Go West
I'm Still Waiting	Jodeci
I'm Overjoyed	Nona Gaye
No Ordinary Love	Sade
360 Degrees (What Goes Around)	Grand Puba
Symphony Of Destruction	Megadeth
Bang Bang	David Sanborn
No One Else On Earth	Wynonna
Drowning In Your Eyes	Ephraim Lewis
Everybody's Free (To Feel Good)	Rozalla
Baby I'm For Real/Natural High	After 7
Always Tomorrow	Gloria Estefan
Take Me In Your Arms	Lil Suzy
Give U My Heart (From "Boomerang")	Babyface (Featuring Toni Braxton)
Really Into You	Around The Way
Rest In Peace	Extreme
Kickin' It	After 7