I Will Always Love You	Whitney Houston
A Whole New World (Aladdin's Theme)	Peabo Bryson & Regina Belle
Ordinary World	Duran Duran
I'm Every Woman (From "The Bodyguard")	Whitney Houston
Saving Forever For You (From "Beverly Hills, 90210")	Shanice
Mr. Wendal	Arrested Development
If I Ever Fall In Love	Shai
7	Prince And The New Power Generation
In The Still Of The Nite (From "The Jacksons")	Boyz II Men
Hip Hop Hooray	Naughty By Nature
Here We Go Again!	Portrait
Nuthin' But A "G" Thang	Dr. Dre
Don't Walk Away	Jade
Get Away	Bobby Brown
Informer	Snow
Rebirth Of Slick (Cool Like Dat)	Digable Planets
Rump Shaker	Wreckx-N-Effect
Bed Of Roses	Bon Jovi
Rhythm Is A Dancer	Snap!
Give It Up, Turn It Loose	En Vogue
When She Cries	Restless Heart
Good Enough	Bobby Brown
Deeper And Deeper	Madonna
Ditty	Paperboy
That's What Love Can Do	Boy Krazy
Comforter	Shai
I Got A Man	Positive K
I'd Die Without You (From "Boomerang")	P.M. Dawn
Walk On The Ocean	Toad The Wet Sprocket
Forever In Love	Kenny G
Do You Believe In Us	Jon Secada
Faithful	Go West
Steam	Peter Gabriel
No Mistakes	Patty Smyth
Real Love	Mary J. Blige
The Right Kind Of Love (From "Beverly Hills, 90210")	Jeremy Jordan
I Got A Thang 4 Ya!	Lo-Key?
What About Your Friends	TLC
Two Princes	Spin Doctors
Sweet Thing	Mary J. Blige
Everything's Gonna Be Alright	Father M.C.
Freak Me	Silk
Quality Time	Hi-Five
No Ordinary Love	Sade
End Of The Road (From "Boomerang")	Boyz II Men
Stand Up (Kick Love Into Motion)	Def Leppard
Dazzey Duks	Duice
To Love Somebody	Michael Bolton
Walking On Broken Glass	Annie Lennox
Angel	Jon Secada
Hat 2 Da Back	TLC
Love Shoulda Brought You Home (From "Boomerang")	Toni Braxton
I Love You Period	Dan Baird
Heal The World	Michael Jackson
It's Gonna Be A Lovely Day	The S.O.U.L. S.Y.S.T.E.M.
Love Is (From "Beverly Hills, 90210")	Vanessa Williams/Brian McKnight
Never A Time	Genesis
Murder She Wrote	Chaka Demus & Pliers
Little Bird	Annie Lennox
Stand	Poison
I'm So Into You	SWV
Man On The Moon	R.E.M.
I'm Gonna Get You	Bizarre Inc
The Last Song	Elton John
Tell The Truth	Jude Cole
Understand This Groove	Sound Factory
Irresistible	Cathy Dennis
Homies	Lighter Shade Of Brown
Love Can Move Mountains	Celine Dion
Little Miss Can't Be Wrong	Spin Doctors
Feels Like Heaven	Peter Cetera (Duet With Chaka Khan)
Gangsta Bitch	Apache
Cat's In The Cradle	Ugly Kid Joe
Reminisce	Mary J. Blige
Bad Girl	Madonna
I See Your Smile	Gloria Estefan
If I Ever Lose My Faith In You	Sting
Gangsta	Bell Biv DeVoe
Baby I'm For Real/Natural High	After 7
Passionate Kisses	Mary Chapin Carpenter
Slow And Sexy	Shabba Ranks (Featuring Johnny Gill)
Come In Out Of The Rain	Wendy Moten
Supermodel (You Better Work)	RuPaul
Sweet Thing	Mick Jagger
Speed	Alpha Team
So Alone	Men At Large
Happy Days	Silk
Hope Of Deliverance	Paul McCartney
Knock-N-Boots	Wreckx-N-Effect
Love's Taken Over	Chante Moore
Losin' Myself	Debbie Gibson
Punks Jump Up To Get Beat Down	Brand Nubian
Beautiful Girl	INXS
Where You Goin' Now	Damn Yankees
Stop The World	Extreme
Lights	Journey
Toss-Up	N2Deep
Get Up (Move Boy Move)	AB Logic
Flex	Mad Cobra
Who's Gonna Ride Your Wild Horses	U2