I'll Make Love To You	Boyz II Men
Stay (I Missed You) (From "Reality Bites")	Lisa Loeb & Nine Stories
Endless Love	Luther Vandross & Mariah Carey
When Can I See You	Babyface
Stroke You Up	Changing Faces
Wild Night	John Mellencamp With Me'Shell Ndegeocello
All I Wanna Do	Sheryl Crow
Can You Feel The Love Tonight (From "The Lion King")	Elton John
Fantastic Voyage	Coolio
This D.J.	Warren G
Don't Turn Around	Ace Of Base
At Your Best (You Are Love)	Aaliyah
Shine	Collective Soul
100% Pure Love	Crystal Waters
I Swear	All-4-One
Never Lie	Immature
If You Go	Jon Secada
Tootsee Roll	69 Boyz
Funkdafied	Da Brat
Flava In Ya Ear	Craig Mack
Lucky One	Amy Grant
Far Behind	Candlebox
Another Night	Real McCoy
Bop Gun (One Nation)	Ice Cube Featuring George Clinton
Come To My Window	Melissa Etheridge
Prayer For The Dying	Seal
The Way She Loves Me	Richard Marx
You Mean The World To Me	Toni Braxton
December 1963 (Oh, What A Night)	The 4 Seasons
I'd Give Anything	Gerald Levert
Letitgo	Prince
Any Time, Any Place/And On And On	Janet Jackson
Juicy/Unbelievable	The Notorious B.I.G.
Circle Of Life (From "The Lion King")	Elton John
Crazy	Aerosmith
Anytime You Need A Friend	Mariah Carey
Body & Soul	Anita Baker
I Miss You	Aaron Hall
Back & Forth	Aaliyah
I'll Stand By You	Pretenders
Do You Wanna Get Funky	C+C Music Factory
Closer	Nine Inch Nails
Love Is All Around	Wet Wet Wet
I'm The Only One	Melissa Etheridge
You Better Wait	Steve Perry
Always	Erasure
Action	Terror Fabulous Featuring Nadine Sutherland
The Sign	Ace Of Base
Back In The Day	Ahmad
I'll Remember (From "With Honors")	Madonna
Nuttin' But Love	Heavy D & The Boyz
Always In My Heart	Tevin Campbell
None Of Your Business	Salt-N-Pepa
What's The Frequency, Kenneth?	R.E.M.
Fade Into You	Mazzy Star
Romantic Call	Patra Featuring Yo-Yo
Booti Call	BLACKstreet
The Lion Sleeps Tonight (Wimoweh)	The Tokens
Afro Puffs	The Lady Of Rage
Thuggish Ruggish Bone	Bone Thugs-N-Harmony
Right Beside You	Sophie B. Hawkins
Good Times	Edie Brickell
New Age Girl (From "Dumb And Dumber")	Deadeye Dick
But It's Alright	Huey Lewis & The News
Nappy Heads	Fugees
What's Up	DJ Miko
Your Body's Callin'	R. Kelly
You Gotta Be	Des'ree
Whipped	Jon Secada
Backwater	Meat Puppets
Can U Get Wit It	Usher
Summer Bunnies	R. Kelly
Give It Up	Public Enemy
Funky Y-2-C	The Puppies
Take It Easy	Mad Lion
Short Dick Man	20 Fingers Featuring Gillette
Here Comes The Hotstepper (From "Ready To Wear")	Ini Kamoze
Girls & Boys	Blur
Don't Take The Girl	Tim McGraw
Willing To Forgive	Aretha Franklin
Selling The Drama	Live
Weekend Love	Queen Latifah
Am I Wrong	Love Spit Love
Playaz Club	Rappin' 4-Tay
Sukiyaki	4PM
The Right Kinda Lover	Patti LaBelle
I'll Take Her	Ill Al Skratch Featuring Brian McKnight
Your Love Is A...	Whitehead Bros.
Sending My Love	Zhane
5-4-3-2 (Yo! Time Is Up)	Jade
The Place Where You Belong (From "Beverly Hills Cop III")	Shai
Third Rock From The Sun	Joe Diffie
Games People Play	Inner Circle
Turn The Beat Around (From "The Specialist")	Gloria Estefan
Be My Baby Tonight	John Michael Montgomery
Hip Hop Ride	Da Youngsta's
Hungah	Karyn White
90's Girl	Blackgirl
Fall Down	Toad The Wet Sprocket
I Saw It Cummin'	PMD