Because You Loved Me (From "Up Close & Personal")	Celine Dion
Nobody Knows	The Tony Rich Project
Sittin' Up In My Room (From "Waiting To Exhale")	Brandy
Down Low (Nobody Has To Know)	R. Kelly Featuring Ronald Isley
Not Gon' Cry (From "Waiting To Exhale")	Mary J. Blige
Ironic	Alanis Morissette
One Sweet Day	Mariah Carey & Boyz II Men
Missing	Everything But The Girl
Follow You Down/Til I Hear It From You	Gin Blossoms
Lady	D'Angelo
All The Things (Your Man Won't Do) (From "Don't Be A Menace...")	Joe
1979	The Smashing Pumpkins
Be My Lover	La Bouche
One Of Us	Joan Osborne
Woo-Hah!! Got You All In Check/Everything Remains Raw	Busta Rhymes
1, 2, 3, 4 (Sumpin' New)	Coolio
Wonderwall	Oasis
Anything	3T
Count On Me (From "Waiting To Exhale")	Whitney Houston & CeCe Winans
Doin It	LL Cool J
Name	Goo Goo Dolls
I Want To Come Over	Melissa Etheridge
Time	Hootie & The Blowfish
Wonder	Natalie Merchant
Who Do U Love	Deborah Cox
Real Love	The Beatles
The World I Know	Collective Soul
Closer To Free (From "Party Of Five")	BoDeans
Fu-Gee-La	Fugees
Peaches	The Presidents Of The United States Of America
Exhale (Shoop Shoop) (From "Waiting To Exhale")	Whitney Houston
Gangsta's Paradise (From "Dangerous Minds")	Coolio Featuring L.V.
I Will Survive	Chantay Savage
No One Else	Total
Before You Walk Out Of My Life/Like This And Like That	Monica
Breakfast At Tiffany's	Deep Blue Something
Hook	Blues Traveler
Feels So Good (Show Me Your Love)	Lina Santiago
Lucky Love	Ace Of Base
Hey Lover	LL Cool J
Don't Cry	Seal
Set U Free	Planet Soul
Tonite's Tha Night	Kris Kross
Tell Me	Groove Theory
Jesus To A Child	George Michael
Cumbersome	Seven Mary Three
Just A Girl	No Doubt
Get Money	Junior M.A.F.I.A. Featuring The Notorious B.I.G.
Only Love (The Ballad Of Sleeping Beauty)	Sophie B. Hawkins
As I Lay Me Down	Sophie B. Hawkins
Do You Want To/Can't Hang	Xscape Featuring MC Lyte
Glycerine	Bush
Insensitive (From "Bed Of Roses")	Jann Arden
Diggin' On You	TLC
5 O'Clock	Nonchalant
Renee	Lost Boyz
You'll See	Madonna
Keep On, Keepin' On (From "Sunset Park")	MC Lyte Featuring Xscape
A Thin Line Between Love & Hate (From "A Thin Line...")	H-Town
Where Do U Want Me To Put It	Solo
Natural One (From "Kids")	Folk Implosion
Only Happy When It Rains	Garbage
Sweet Dreams	La Bouche
We Got It	Immature (Featuring Smooth)
Amish Paradise	"Weird Al" Yankovic
Soon As I Get Home	Faith Evans
Stayin' Alive	N-Trance
I Got Id/Long Road	Pearl Jam
Keep Tryin'	Groove Theory
Can't Be Wasting My Time (From "Don't Be A Menace...")	Mona Lisa Featuring Lost Boyz
Visions Of A Sunset (From "Mr. Holland's Opus")	Shawn Stockman
Release Me	Angelina
Let's Play House	Tha Dogg Pound Featuring Michel'le
Caught A Lite Sneeze	Tori Amos
Everyday & Everynight	Yvette Michele
Take A Look	J'Son
Have I Never	A Few Good Men
Give Me...A Reason	Buffy
Stairway To Heaven	Pure Soul
High And Dry	Radiohead
Funkorama	Redman
Scent Of Attraction	Patra Duet With Aaron Hall
La Familia	Frost
Ridin' Low	L.A.D.
Ain't No Playa	Rappin' 4-Tay
Envy/Firewater	Fat Joe
Physical Funk	Domino
C'mon N' Ride It (The Train)	Quad City DJ's
Ever Since You Went Away	Art N' Soul
Esa Nena Linda	Artie The 1 Man Party
Beware Of My Crew (From "A Thin Line Between Love And Hate")	L.B.C. Crew Feat. Tray D & South Sentrell
One For The Money	Horace Brown
Can't Get You Off My Mind	Lenny Kravitz
Ain't Nobody	Diana King
Soul Food	Goodie Mob
It Matters To Me	Faith Hill
Let Your Soul Be Your Pilot	Sting
All Cried Out	Denine With Collage's Adam Marano
Celebration/Take Your Chance	Fun Factory
You Remind Me Of Something	R. Kelly