Candle In The Wind 1997/Something About The Way You Look Tonight	Elton John
4 Seasons Of Loneliness	Boyz II Men
How Do I Live	LeAnn Rimes
You Make Me Wanna...	Usher
Honey	Mariah Carey
Quit Playing Games (With My Heart)	Backstreet Boys
Semi-Charmed Life	Third Eye Blind
Mo Money Mo Problems	The Notorious B.I.G. Featuring Puff Daddy & Mase
Foolish Games/You Were Meant For Me	Jewel
2 Become 1	Spice Girls
I'll Be Missing You	Puff Daddy & Faith Evans Featuring 112
All Cried Out	Allure Featuring 112
Building A Mystery	Sarah McLachlan
All For You	Sister Hazel
Invisible Man	98 Degrees
My Love Is The Shhh!	Somethin' For The People Featuring Trina & Tamara
You Should Be Mine (Don't Waste Your Time)	Brian McKnight Featuring Mase
The One I Gave My Heart To	Aaliyah
Up Jumps Da Boogie	Magoo And Timbaland
What About Us	Total
Tubthumping	Chumbawamba
Not Tonight	Lil' Kim Feat. Da Brat, Left Eye, Missy Elliott & Angie Mar
Sunny Came Home	Shawn Colvin
Everything	Mary J. Blige
Do You Know (What It Takes)	Robyn
Butta Love	Next
Never Make A Promise	Dru Hill
Criminal	Fiona Apple
Barbie Girl	Aqua
I Miss My Homies	Master P Featuring Pimp C And The Shocker
I Care 'Bout You	Milestone
The Freshmen	The Verve Pipe
Bitch	Meredith Brooks
You Light Up My Life	LeAnn Rimes
Barely Breathing	Duncan Sheik
Return Of The Mack	Mark Morrison
Avenues	Refugee Camp All Stars Featuring Pras (With Ky-mani)
Coco Jamboo	Mr. President
On My Own	Peach Union
Backyard Boogie	Mack 10
ESPN Presents The Jock Jam	Various Artists
For You I Will (From "Space Jam")	Monica
Do You Like This	Rome
Too Gone, Too Long	En Vogue
G.H.E.T.T.O.U.T.	Changing Faces
Say You'll Be There	Spice Girls
Legend Of A Cowgirl	Imani Coppola
I Want You	Savage Garden
Hard To Say I'm Sorry	Az Yet Featuring Peter Cetera
I Say A Little Prayer	Diana King
Someone	SWV (Featuring Puff Daddy)
Me And My Crazy World	Lost Boyz
All I Want (From "GOOD Burger")	702
Have A Little Mercy	4.0
C U When U Get There (From "Nothing To Lose")	Coolio Featuring 40 Thevz
No Tengo Dinero	Los Umbrellos
Gotham City	R. Kelly
Heaven	Nu Flavor
After 12, Before 6	Sam Salter
I Can Love You	Mary J. Blige
Around The World	Daft Punk
Big Bad Mamma (From "Def Jam's How To Be A Player")	Foxy Brown Featuring Dru Hill
Love Gets Me Every Time	Shania Twain
Don't Go	Le Click Featuring Kayo
Electric Barbarella	Duran Duran
When I Die	No Mercy
To The Moon And Back	Savage Garden
Don't Say	Jon B
As We Lay	Dana
They Like It Slow	H-Town
Love Is Alive	3rd Party
Last Night's Letter	K-Ci & JoJo
Go The Distance (From "Hercules")	Michael Bolton
More Than This	10,000 Maniacs
We Can Get Down	Myron
I'm Not A Fool	Immature
Valentine	Martina McBride With Jim Brickman
The Way That You Talk	Jagged Edge Featuring Da Brat & JD
Piece Of My Heart	Shaggy (Featuring Marsha)
Jack-Ass	Beck
Look Into My Eyes (From "Batman & Robin")	Bone Thugs-N-Harmony
Down For Yours	Nastyboy Klick Featuring Roger Troutman
Things Just Ain't The Same	Deborah Cox
Hole In My Soul	Aerosmith
Free	Ultra Nate
Please	The Kinleys
A Smile Like Yours (From "A Smile Like Yours")	Natalie Cole
Smile	Scarface Featuring 2Pac & Johnny P
Alone	Bee Gees
Take It To The Streets	Rampage Featuring Billy Lawrence
Alright	Jamiroquai
Spin Spin Sugar	Sneaker Pimps
Men Of Steel (From "Steel")	Shaquille O'Neal, Ice Cube, B Real, Peter Gunz & KRS-One
Go Away	Lorrie Morgan
You Bring Me Up	K-Ci & JoJo
Four Leaf Clover	Abra Moore
To Make You Feel My Love	Billy Joel
Off The Books	The Beatnuts Featuring Big Punisher & Cuban Link
Can We (From "Booty Call")	SWV
Whatever	En Vogue