U Remind Me	Usher
Hit 'Em Up Style (Oops!)	Blu Cantrell
Let Me Blow Ya Mind	Eve Featuring Gwen Stefani
Peaches & Cream	112
Hanging By A Moment	Lifehouse
Drops Of Jupiter (Tell Me)	Train
Lady Marmalade	Christina Aguilera, Lil' Kim, Mya & P!nk
Bootylicious	Destiny's Child
All Or Nothing	O-Town
Drive	Incubus
Get Ur Freak On	Missy "Misdemeanor" Elliott
What Would You Do?	City High
Where The Party At	Jagged Edge With Nelly
Ride Wit Me	Nelly Featuring City Spud
It's Been Awhile	Staind
Follow Me	Uncle Kracker
Someone To Call My Lover	Janet
Irresistible	Jessica Simpson
Fill Me In	Craig David
Superwoman Pt. II	Lil' Mo Featuring Fabolous
When It's Over	Sugar Ray
Fiesta	R. Kelly Featuring Jay-Z
Purple Hills	D12
Music	Erick Sermon Featuring Marvin Gaye
I'm Real	Jennifer Lopez Featuring Ja Rule
She's All I Got	Jimmy Cozier
More Than That	Backstreet Boys
There You'll Be	Faith Hill
Thank You	Dido
Fallin'	Alicia Keys
I'm Already There	Lonestar
Wait A Minute	Ray J Featuring Lil' Kim
Here's To The Night	Eve 6
I Wanna Be Bad	Willa Ford
My Baby	Lil' Romeo
I'm Like A Bird	Nelly Furtado
She Couldn't Change Me	Montgomery Gentry
Take You Out	Luther Vandross
The Space Between	Dave Matthews Band
All For You	Janet
Pop	'N Sync
Austin	Blake Shelton
When I Think About Angels	Jamie O'Neal
I Hope You Dance	Lee Ann Womack
There She Goes	Babyface
I Do!!	Toya
Flavor Of The Weak	American Hi-Fi
If You're Gone	matchbox twenty
I'm Just Talkin' About Tonight	Toby Keith
I Could Not Ask For More	Sara Evans
Two People Fell In Love	Brad Paisley
Grown Men Don't Cry	Tim McGraw
Where The Blacktop Ends	Keith Urban
Contagious	The Isley Brothers Featuring Ronald Isley
One Minute Man	Missy "Misdemeanor" Elliott
When Somebody Loves You	Alan Jackson
Ain't Nothing 'Bout You	Brooks & Dunn
What I Really Meant To Say	Cyndi Thomson
Downtime	Jo Dee Messina
Can't Believe	Faith Evans Featuring Carl Thomas
Loverboy	Mariah Carey Featuring Cameo
If You Can Do Anything Else	George Strait
Don't Happen Twice	Kenny Chesney
We Need A Resolution	Aaliyah Featuring Timbaland
Just In Case	Jaheim
What It Is	Violator Featuring Busta Rhymes
This Is Me	Dream
Only Time	Enya
Heard It All Before	Sunshine Anderson
Area Codes	Ludacris Featuring Nate Dogg
Schism	Tool
Play	Jennifer Lopez
The Way	Jill Scott
Laredo	Chris Cagle
I Like Them Girls	Tyrese
While You Loved Me	Rascal Flatts
Only In America	Brooks & Dunn
I'm A Believer	Smash Mouth
Take It To Da House	Trick Daddy Featuring The SNS Express
Survivor	Destiny's Child
Why They Call It Falling	Lee Ann Womack
I Cry	Ja Rule Featuring Lil' Mo
Mad Season	matchbox twenty
Baby, Come Over (This Is Our Night)	Samantha Mumba
Right Where I Need To Be	Gary Allan
Angel	Lionel Richie
La Bomba	Azul Azul
Midwest Swing	St. Lunatics
Miss California	Dante Thomas Featuring Pras
Just A Baby Boy	Snoop Dogg Featuring Tyrese & Mr. Tan
Maybe I Deserve	Tank
Sandstorm	Darude
Lay Low	Snoop Dogg Featuring Master P, Nate Dogg, Butch Cassidy & Tha Eastsidaz
Yellow	Coldplay
My Way	Limp Bizkit
Video	India.Arie
Let's Get It	Three The... G. Dep, P. Diddy & Black Rob
Can't Deny It	Fabolous Featuring Nate Dogg
I'm A Thug	Trick Daddy
Until The End Of Time	2Pac