In Da Club	50 Cent
Ignition	R. Kelly
Get Busy	Sean Paul
When I'm Gone	3 Doors Down
21 Questions	50 Cent Featuring Nate Dogg
Beautiful	Snoop Dogg Featuring Pharrell & Uncle Charlie Wilson
Picture	Kid Rock Featuring Sheryl Crow Or Allison Moorer
I Know What You Want	Busta Rhymes & Mariah Carey Featuring The Flipmode Squad
Miss You	Aaliyah
Can't Let You Go	Fabolous Featuring Mike Shorey & Lil' Mo
Rock Your Body	Justin Timberlake
How You Gonna Act Like That	Tyrese
I Can	Nas
Excuse Me Miss	JAY-Z
Bring Me To Life	Evanescence Featuring Paul McCoy
Sing For The Moment	Eminem
Hell Yeah	Ginuwine Featuring Baby
All I Have	Jennifer Lopez Featuring LL Cool J
The Jump Off	Lil' Kim Featuring Mr. Cheeks
No Letting Go	Wayne Wonder
Angel	Amanda Perez
I'm With You	Avril Lavigne
If You're Not The One	Daniel Bedingfield
Have You Forgotten?	Darryl Worley
Beautiful	Christina Aguilera
Mesmerize	Ja Rule Featuring Ashanti
Unwell	matchbox twenty
Big Star	Kenny Chesney
That'd Be Alright	Alan Jackson
Girlfriend	B2K
Put That Woman First	Jaheim
The Game Of Love	Santana Featuring Michelle Branch
She's My Kind Of Rain	Tim McGraw
Somewhere I Belong	Linkin Park
Clocks	Coldplay
Your Body Is A Wonderland	John Mayer
American Life	Madonna
Like A Stone	Audioslave
Say Yes	Floetry
Gossip Folks	Missy "Misdemeanor" Elliott Featuring Ludacris
Drift Away	Uncle Kracker Featuring Dobie Gray
Cry Me A River	Justin Timberlake
The Anthem	Good Charlotte
Brokenheartsville	Joe Nichols
Don't Know Why	Norah Jones
Fighter	Christina Aguilera
Concrete Angel	Martina McBride
Sick Of Being Lonely	Field Mob
Bump, Bump, Bump	B2K & P. Diddy
Raining On Sunday	Keith Urban
I Believe	Diamond Rio
Big Yellow Taxi	Counting Crows Featuring Vanessa Carlton
What A Beautiful Day	Chris Cagle
What Would You Do?	The Isley Brothers Featuring Ronald Isley
Three Wooden Crosses	Randy Travis
Emotional Rollercoaster	Vivian Green
Beware Of The Boys (Mundian To Bach Ke)	Panjabi MC Featuring Jay-Z
Don't Wanna Try	Frankie J
Headstrong	Trapt
4 Ever	Lil' Mo Featuring Fabolous
Love You Out Loud	Rascal Flatts
Superman	Eminem
Pimp Juice	Nelly
Girl All The Bad Guys Want	Bowling For Soup
Times Like These	Foo Fighters
So Gone	Monica
Can't Stop	Red Hot Chili Peppers
Man To Man	Gary Allan
Snake	R. Kelly Featuring Big Tigger
Price To Play	Staind
Losing Grip	Avril Lavigne
All The Things She Said	t.A.T.u.
My Front Porch Looking In	Lonestar
Pump It Up	Joe Budden
Magic Stick	Lil' Kim Featuring 50 Cent
Stay Gone	Jimmy Wayne
Get By	Talib Kweli
I Drove All Night	Celine Dion
Still Ballin	2Pac Featuring Trick Daddy
Soldier's Heart	R. Kelly
Never Scared	Bone Crusher Featuring Killer Mike & T.I.
Speed	Montgomery Gentry
Straight Out Of Line	Godsmack
Peacekeeper	Fleetwood Mac
Can't Stop Loving You	Phil Collins
X Gon' Give It To Ya	DMX
In Love Wit Chu	Da Brat Featuring Cherish
No One Knows	Queens Of The Stone Age
Fine Again	Seether
Running	No Doubt
I'd Do Anything	Simple Plan
Stupid Girl	Cold
What Happened To That Boy	Baby Featuring Clipse
Blowin' Me Up (With Her Love)	JC Chasez
Always	Saliva
No One's Gonna Change You	Reina
Like A Pimp	David Banner Featuring Lil' Flip
Don't Dream It's Over	Sixpence None The Richer
Try It On My Own	Whitney Houston
Lifestyles Of The Rich And Famous	Good Charlotte