Burn	Usher
Confessions Part II	Usher
The Reason	Hoobastank
I Don't Wanna Know	Mario Winans Featuring Enya & P. Diddy
If I Ain't Got You	Alicia Keys
Overnight Celebrity	Twista
Naughty Girl	Beyonce
This Love	Maroon 5
Freek-A-Leek	Petey Pablo
Yeah!	Usher Featuring Lil Jon & Ludacris
Roses	OutKast
Slow Motion	Juvenile Featuring Soulja Slim
Move Ya Body	Nina Sky Featuring Jabba
On Fire	Lloyd Banks
All Falls Down	Kanye West Featuring Syleena Johnson
Jesus Walks	Kanye West
Everytime	Britney Spears
Tipsy	J-Kwon
Meant To Live	Switchfoot
Turn Me On	Kevin Lyttle Featuring Spragga Benz
Leave (Get Out)	JoJo
Don't Tell Me	Avril Lavigne
Dirt Off Your Shoulder	JAY-Z
My Immortal	Evanescence
Heaven	Los Lonely Boys
Dip It Low	Christina Milian
U Should've Known Better	Monica
Happy People	R. Kelly
Hey Mama	The Black Eyed Peas
99 Problems	JAY-Z
Redneck Woman	Gretchen Wilson
Whiskey Girl	Toby Keith
Here Without You	3 Doors Down
Dude	Beenie Man Featuring Ms. Thing
Welcome Back	Mase
If You Ever Stop Loving Me	Montgomery Gentry
Ocean Avenue	Yellowcard
Let's Be Us Again	Lonestar
Talk About Our Love	Brandy Featuring Kanye West
Someday	Nickelback
100 Years	Five For Fighting
Game Over (Flip)	Lil' Flip
Scandalous	Mis-Teeq
Diary	Alicia Keys Featuring Tony! Toni! Tone!
Culo	Pitbull Featuring Lil Jon
Letters From Home	John Michael Montgomery
Live Like You Were Dying	Tim McGraw
Loco	David Lee Murphy
The First Cut Is The Deepest	Sheryl Crow
White Flag	Dido
Southside	Lloyd Featuring Ashanti
Lean Back	Terror Squad
I Go Back	Kenny Chesney
Whats Happnin!	Ying Yang Twins Featuring Trick Daddy
My Band	D12
I Like That	Houston Featuring Chingy, Nate Dogg & I-20
That's What She Gets For Loving Me	Brooks & Dunn
Sunshine	Lil' Flip Featuring Lea
When The Sun Goes Down	Kenny Chesney & Uncle Kracker
Slither	Velvet Revolver
Accidentally In Love	Counting Crows
Whiskey Lullaby	Brad Paisley Featuring Alison Krauss
Mayberry	Rascal Flatts
Hey Good Lookin'	Jimmy Buffett With Clint Black, Kenny Chesney, Alan Jackson, Toby Keith & George Strait
Somebody	Reba McEntire
Jook Gal (Wine Wine)	Elephant Man
You'll Think Of Me	Keith Urban
Got It Twisted	Mobb Deep
Ch-Check It Out	Beastie Boys
Take My Breath Away	Jessica Simpson
Cold Hard Bitch	Jet
Still In Love	Teena Marie Featuring Baby
I Got A Feelin'	Billy Currington
I Can't Sleep	Clay Walker
So Sexy	Twista Featuring R. Kelly
Everything	Alanis Morissette
Passenger Seat	SHeDAISY
Where Are We Runnin'?	Lenny Kravitz
Don't Take Your Love Away	Avant
Selfish	Slum Village Featuring Kanye West & John Legend
Love Song	311
I Miss You	Blink-182
Get No Better	Cassidy Featuring Mashonda
Lying From You	Linkin Park
Tear It Up	Yung Wun Featuring DMX, Lil' Flip & David Banner
You're The Only One	Maria Mena
Love's Divine	Seal
Time's Up!	Jadakiss Featuring Nate Dogg
Paint Me A Birmingham	Tracy Lawrence
Float On	Modest Mouse
Locked Up	Akon Featuring Styles P.
whoknows	Musiq
So Fly	NB Ridaz Featuring Gemini
Goodies	Ciara Featuring Petey Pablo
8th World Wonder	Kimberley Locke
You Raise Me Up	Josh Groban
Coo-Coo Chee	Ric-A-Che Featuring Darija
Just For You	Lionel Richie
Desperately	George Strait
This Way	Dilated Peoples Featuring Kanye West