We Belong Together	Mariah Carey
Pon de Replay	Rihanna
Hollaback Girl	Gwen Stefani
Don't Cha	The Pussycat Dolls Featuring Busta Rhymes
Don't Phunk With My Heart	The Black Eyed Peas
Lose Control	Missy Elliott Featuring Ciara & Fat Man Scoop
Behind These Hazel Eyes	Kelly Clarkson
Let Me Hold You	Bow Wow Featuring Omarion
Get It Poppin'	Fat Joe Featuring Nelly
Just A Lil Bit	50 Cent
Grind With Me	Pretty Ricky
Pimpin' All Over The World	Ludacris Featuring Bobby Valentino
You And Me	Lifehouse
Listen To Your Heart	D.H.T.
Oh	Ciara Featuring Ludacris
Switch	Will Smith
Inside Your Heaven	Carrie Underwood
Scars	Papa Roach
Best Of You	Foo Fighters
These Boots Are Made For Walkin'	Jessica Simpson
Speed Of Sound	Coldplay
Cater 2 U	Destiny's Child
Beverly Hills	Weezer
Lonely No More	Rob Thomas
Feel Good Inc	Gorillaz
Inside Your Heaven	Bo Bice
Holiday	Green Day
Back Then	Mike Jones
Since U Been Gone	Kelly Clarkson
As Good As I Once Was	Toby Keith
Let Me Go	3 Doors Down
Mr. Brightside	The Killers
Give Me That	Webbie Featuring Bun B
Collide	Howie Day
Chariot	Gavin DeGraw
Dreams	The Game
Slow Down	Bobby Valentino
Baby I'm Back	Baby Bash Featuring Akon
How To Deal	Frankie J
Incomplete	Backstreet Boys
Free Yourself	Fantasia
Fast Cars And Freedom	Rascal Flatts
Mississippi Girl	Faith Hill
Something More	Sugarland
Boulevard Of Broken Dreams	Green Day
Summer Nights	Lil Rob
Trapped In The Closet	R. Kelly
These Words	Natasha Bedingfield
Make Her Feel Good	Teairra Mari
Cool	Gwen Stefani
La Tortura	Shakira Feat. Alejandro Sanz
So Seductive	Tony Yayo Featuring 50 Cent
Must Be Nice	Lyfe Jennings
Making Memories Of Us	Keith Urban
Sugar, We're Goin' Down	Fall Out Boy
Untitled (How Can This Happen To Me?)	Simple Plan
Breathe (2 AM)	Anna Nalick
Dem Boyz	Boyz N Da Hood
Badd	Ying Yang Twins Featuring Mike Jones & Mr. ColliPark
You'll Be There	George Strait
Don't Worry 'Bout A Thing	SHeDAISY
B.Y.O.B.	System Of A Down
A Real Fine Place To Start	Sara Evans
Pickin' Wildflowers	Keith Anderson
Playa's Only	R. Kelly Featuring The Game
Shake It Off	Mariah Carey
Outta Control (Remix)	50 Cent Feat. Mobb Deep
Play	David Banner
Diamonds From Sierra Leone	Kanye West
This Is How A Heart Breaks	Rob Thomas
Play Something Country	Brooks & Dunn
Tell Me	Bobby Valentino
Energy	Natalie Featuring Baby Bash
Alcohol	Brad Paisley
Gotta Getcha	Jermaine Dupri
And Then What	Young Jeezy Featuring Mannie Fresh
The Hand That Feeds	Nine Inch Nails
Goodbye Time	Blake Shelton
Keg In The Closet	Kenny Chesney
Helena (So Long & Goodnight)	My Chemical Romance
Do You Want Fries With That	Tim McGraw
ASAP	T.I.
Just The Girl	The Click Five
Notice Me	NB Ridaz Featuring Angelina
Right Here	Staind
Go!	Common
Help Somebody	Van Zant
Be My Escape	Relient K
I Can't Stop Loving You	Kem
Girl	Destiny's Child
Lot Of Leavin' Left To Do	Dierks Bentley
Gold Digger	Kanye West Featuring Jamie Foxx
My Sister	Reba McEntire
Touch	Omarion
Like You	Daddy Yankee
Welcome To Jamrock	Damian "Jr. Gong" Marley
Home	Michael Buble
Ass Like That	Eminem
Somebody's Hero	Jamie O'Neal
Remedy	Seether