Give It To Me	Timbaland Featuring Nelly Furtado & Justin Timberlake
Don't Matter	Akon
Girlfriend	Avril Lavigne
Glamorous	Fergie Featuring Ludacris
The Sweet Escape	Gwen Stefani Featuring Akon
This Is Why I'm Hot	Mims
Buy U A Drank (Shawty Snappin')	T-Pain Featuring Yung Joc
Beautiful Liar	Beyonce & Shakira
Cupid's Chokehold/Breakfast In America	Gym Class Heroes Featuring Patrick Stump
Last Night	Diddy Featuring Keyshia Cole
U + Ur Hand	P!nk
I'm A Flirt	R. Kelly Or Bow Wow (Featuring T.I. & T-Pain)
What I've Done	Linkin Park
It's Not Over	Daughtry
Before He Cheats	Carrie Underwood
What Goes Around...Comes Around	Justin Timberlake
Say It Right	Nelly Furtado
If Everyone Cared	Nickelback
Go Getta	Young Jeezy Featuring R. Kelly
Lost Without U	Robin Thicke
The Way I Live	Baby Boy Da Prince Featuring Lil Boosie
Like A Boy	Ciara
Pop, Lock & Drop It	Huey
Face Down	The Red Jumpsuit Apparatus
Last Dollar (Fly Away)	Tim McGraw
Ice Box	Omarion
Throw Some D's	Rich Boy Featuring Polow Da Don
With Love	Hilary Duff
2 Step	Unk
Irreplaceable	Beyonce
Home	Daughtry
Outta My System	Bow Wow Featuring T-Pain & Johnta Austin
Better Than Me	Hinder
Rock Yo Hips	Crime Mob Featuring Lil Scrappy
I Tried	Bone Thugs-N-Harmony Featuring Akon
Get It Shawty	Lloyd
How To Save A Life	The Fray
This Ain't A Scene, It's An Arms Race	Fall Out Boy
Walk It Out	Unk
Over It	Katharine McPhee
You	Lloyd Featuring Lil Wayne
Make It Rain	Fat Joe Featuring Lil Wayne
Wasted	Carrie Underwood
Candyman	Christina Aguilera
We Takin' Over	DJ Khaled Featuring T.I., Akon, Rick Ross, Fat Joe, Lil' Wayne & Baby
I Wanna Love You	Akon Featuring Snoop Dogg
Because Of You	Ne-Yo
Buddy	Musiq Soulchild
Smack That	Akon Featuring Eminem
Waiting On The World To Change	John Mayer
Ticks	Brad Paisley
Teardrops On My Guitar	Taylor Swift
Hey There Delilah	Plain White T's
Stand	Rascal Flatts
Good Directions	Billy Currington
Doe Boy Fresh	Three 6 Mafia Featuring Chamillionaire
Settlin'	Sugarland
Break It Off	Rihanna & Sean Paul
Keep Holding On	Avril Lavigne
Lost In This Moment	Big & Rich
Top Back	T.I.
She's Like The Wind	Lumidee Featuring Tony Sunshine
Stolen	Dashboard Confessional
Anyway	Martina McBride
Read My Mind	The Killers
On The Hotline	Pretty Ricky
Thnks Fr Th Mmrs	Fall Out Boy
Grace Kelly	MIKA
Little Wonders	Rob Thomas
Look After You	The Fray
Pain	Three Days Grace
Into The Ocean	Blue October
Beer In Mexico	Kenny Chesney
Summer Love	Justin Timberlake
The Story (I Was Made For You)	Brandi Carlile
Long Trip Alone	Dierks Bentley
Poppin'	Chris Brown Featuring Jay Biz
Makes Me Wonder	Maroon 5
High Maintenance Woman	Toby Keith
Forever	Papa Roach
Like This	Kelly Rowland Featuring Eve
Moments	Emerson Drive
Stupid Boy	Keith Urban
Earth Intruders	Bjork
Upgrade U	Beyonce Featuring Jay Z
Que Hiciste	Jennifer Lopez
I'll Wait For You	Joe Nichols
A Woman's Love	Alan Jackson
Find Out Who Your Friends Are	Tracy Lawrence
Please Don't Go	Tank
Umbrella	Rihanna Featuring Jay-Z
Apologize	Timbaland Featuring OneRepublic
The River	Good Charlotte Featuring M. Shadows And Synyster Gates
I'm Throwed	Paul Wall Featuring Jermaine Dupri
Ladies Love Country Boys	Trace Adkins
Breath	Breaking Benjamin
Smile	Lily Allen
Kiss The Girl	Ashley Tisdale
When I See U	Fantasia
It's Me Snitches	Swizz Beatz