Irreplaceable	Beyonce
I Wanna Love You	Akon Featuring Snoop Dogg
Fergalicious	Fergie
Say It Right	Nelly Furtado
Smack That	Akon Featuring Eminem
We Fly High	Jim Jones
How To Save A Life	The Fray
My Love	Justin Timberlake Featuring T.I.
Welcome To The Black Parade	My Chemical Romance
It Ends Tonight	The All-American Rejects
Shortie Like Mine	Bow Wow Featuring Chris Brown & Johnta Austin
What Goes Around...Comes Around	Justin Timberlake
Runaway Love	Ludacris Featuring Mary J. Blige
Lips Of An Angel	Hinder
Walk It Out	Unk
SexyBack	Justin Timberlake
Promise	Ciara
You	Lloyd Featuring Lil Wayne
Make It Rain	Fat Joe Featuring Lil Wayne
Walk Away (Remember Me)	Paula DeAnda Featuring The DEY
It's Not Over	Daughtry
Keep Holding On	Avril Lavigne
Waiting On The World To Change	John Mayer
Chasing Cars	Snow Patrol
That's That	Snoop Dogg Featuring R. Kelly
Before He Cheats	Carrie Underwood
Money Maker	Ludacris Featuring Pharrell
Far Away	Nickelback
Hurt	Christina Aguilera
Ice Box	Omarion
The Sweet Escape	Gwen Stefani Featuring Akon
Wait A Minute	The Pussycat Dolls Featuring Timbaland
Snow ((Hey Oh))	Red Hot Chili Peppers
I Luv It	Young Jeezy
Suddenly I See	KT Tunstall
Wind It Up	Gwen Stefani
Boston	Augustana
Here (In Your Arms)	Hellogoodbye
Watching You	Rodney Atkins
Tim McGraw	Taylor Swift
Through Glass	Stone Sour
She's Everything	Brad Paisley
What Hurts The Most	Rascal Flatts
Say Goodbye	Chris Brown
Too Little Too Late	JoJo
Money In The Bank	Lil Scrappy Featuring Young Buck
Call Me When You're Sober	Evanescence
White & Nerdy	"Weird Al" Yankovic
My Wish	Rascal Flatts
Top Back	T.I.
Tell Me	Diddy Featuring Christina Aguilera
Face Down	The Red Jumpsuit Apparatus
Stupid Boy	Keith Urban
Poppin'	Chris Brown Featuring Jay Biz
Into The Ocean	Blue October
Pain	Three Days Grace
Rockstar	Nickelback
Here It Goes Again	OK Go
Amarillo Sky	Jason Aldean
Want To	Sugarland
Zoom	Lil' Boosie Featuring Yung Joc
My Little Girl	Tim McGraw
It Just Comes Natural	George Strait
Maneater	Nelly Furtado
Break It Off	Rihanna & Sean Paul
Red High Heels	Kellie Pickler
Lost Without U	Robin Thicke
Listen	Beyonce
Jump To The Rhythm	Jordan Pruitt
Lost One	Jay-Z Featuring Chrisette Michele
Stuntin' Like My Daddy	Birdman & Lil Wayne
Alyssa Lies	Jason Michael Carroll
The Way I Live	Baby Boy Da Prince Featuring Lil Boosie
Ladies Love Country Boys	Trace Adkins
Throw Some D's	Rich Boy Featuring Polow Da Don
On The Hotline	Pretty Ricky
He Said She Said	Ashley Tisdale
If We Were A Movie	Hannah Montana
Streetcorner Symphony	Rob Thomas
Come To Me	Diddy Featuring Nicole Scherzinger
And I Am Telling You I'm Not Going	Jennifer Hudson
You Don't Know	Eminem, 50 Cent, Lloyd Banks & Ca$his
Cupid's Chokehold/Breakfast In America	Gym Class Heroes Featuring Patrick Stump
Show Me What You Got	JAY-Z
Unappreciated	Cherish
Nothing Left To Lose	Mat Kearney
King Kong	Jibbs Featuring Chamillionaire
Come Back To Me	Vanessa Hudgens
Love Like Winter	AFI
Little Bit Of Life	Craig Morgan
U + Ur Hand	P!nk
Mr. Jones	Mike Jones
Anna-Molly	Incubus
My, Oh My	The Wreckers
Upgrade U	Beyonce Featuring Jay Z
Take Me As I Am	Mary J. Blige
Honestly	Cartel
Glamorous	Fergie Featuring Ludacris
Ay Chico (Lengua Afuera)	Pitbull
You Save Me	Kenny Chesney