Firework	Katy Perry
What's My Name?	Rihanna Featuring Drake
Grenade	Bruno Mars
Raise Your Glass	P!nk
We R Who We R	Ke$ha
Only Girl (In The World)	Rihanna
Just The Way You Are	Bruno Mars
The Time (Dirty Bit)	The Black Eyed Peas
Just A Dream	Nelly
Bottoms Up	Trey Songz Featuring Nicki Minaj
Black And Yellow	Wiz Khalifa
Like A G6	Far*East Movement Featuring Cataracs & Dev
DJ Got Us Fallin' In Love	Usher Featuring Pitbull
Dynamite	Taio Cruz
Tonight (I'm Lovin' You)	Enrique Iglesias Featuring Ludacris & DJ Frank E
No Hands	Waka Flocka Flame Featuring Roscoe Dash & Wale
Please Don't Go	Mike Posner
That's All She Wrote	T.I. Featuring Eminem
Stereo Love	Edward Maya & Vika Jigulina
Teenage Dream	Katy Perry
Animal	Neon Trees
Yeah 3X	Chris Brown
F**k You! (Forget You)	CeeLo Green
Coming Home	Diddy - Dirty Money Featuring Skylar Grey
Secrets	OneRepublic
Right Thru Me	Nicki Minaj
Whip My Hair	WILLOW
If I Die Young	The Band Perry
Right Above It	Lil Wayne Featuring Drake
Club Can't Handle Me	Flo Rida Featuring David Guetta
I Like It	Enrique Iglesias Featuring Pitbull
Hey Baby (Drop It To The Floor)	Pitbull Featuring T-Pain
Aston Martin Music	Rick Ross Featuring Drake & Chrisette Michele
Back To December	Taylor Swift
Christmas Lights	Coldplay
Deuces	Chris Brown Featuring Tyga & Kevin McCall
Somewhere With You	Kenny Chesney
No Love	Eminem Featuring Lil Wayne
My Kinda Party	Jason Aldean
Love The Way You Lie	Eminem Featuring Rihanna
Felt Good On My Lips	Tim McGraw
Love Like Woe	The Ready Set
Stuck Like Glue	Sugarland
Can't Be Friends	Trey Songz
Pretty Girl Rock	Keri Hilson
Memories	David Guetta Featuring Kid Cudi
As She's Walking Away	Zac Brown Band Featuring Alan Jackson
Dog Days Are Over	Florence + The Machine
Jar Of Hearts	Christina Perri
Mine	Taylor Swift
We No Speak Americano	Yolanda Be Cool & Dcup
Kush	Dr. Dre Featuring Snoop Dogg & Akon
Turn On The Radio	Reba
Who Are You When I'm Not Looking	Blake Shelton
Rhythm of Love	Plain White T's
Mama's Song	Carrie Underwood
Baby, It's Cold Outside	Glee Cast
Why Wait	Rascal Flatts
Welcome Christmas	Glee Cast
Rocketeer	Far*East Movement Featuring Ryan Tedder
Put You In A Song	Keith Urban
Down On Me	Jeremih Featuring 50 Cent
Only Prettier	Miranda Lambert
Lay It Down	Lloyd
Hold My Hand	Michael Jackson Duet With Akon
The Breath You Take	George Strait
Who Dat Girl	Flo Rida Featuring Akon
Rolling In The Deep	Adele
Voices	Chris Young
Don't You Wanna Stay	Jason Aldean With Kelly Clarkson
Let Me Down Easy	Billy Currington
Anything Like Me	Brad Paisley
Runaway	Kanye West Featuring Pusha T
Waiting For The End	Linkin Park
Fancy	Drake Featuring T.I. & Swizz Beatz
Maybe	Sick Puppies
Hello World	Lady Antebellum
Someone Else Calling You Baby	Luke Bryan
All I Want Is You	Miguel Featuring J. Cole
Make A Movie	Twista Featuring Chris Brown
Little Lion Man	Mumford & Sons
Fire Flame	Birdman Featuring Lil Wayne
Angel	Akon
Bullets In The Gun	Toby Keith
Marry Me	Train
Letting Go (Dutty Love)	Sean Kingston Featuring Nicki Minaj
Smoke A Little Smoke	Eric Church
Shake	Jesse McCartney
No BS	Chris Brown
Loca	Shakira Featuring El Cata or Dizzee Rascal
Strip Me	Natasha Bedingfield
Forget You	Glee Cast Featuring Gwyneth Paltrow
Monster	Kanye West Featuring Jay-Z, Rick Ross, Bon Iver & Nicki Minaj
Bass Down Low	Dev Featuring The Cataracs
Fall For Your Type	Jamie Foxx Featuring Drake
September	Daughtry
One In A Million	Ne-Yo
Marry You	Bruno Mars
Porn Star Dancing	My Darkest Days Featuring Zakk Wylde
Bon, Bon	Pitbull