Someone Like You	Adele
Moves Like Jagger	Maroon 5 Featuring Christina Aguilera
Pumped Up Kicks	Foster The People
Stereo Hearts	Gym Class Heroes Featuring Adam Levine
Party Rock Anthem	LMFAO Featuring Lauren Bennett & GoonRock
Sexy And I Know It	LMFAO
Strange Clouds	B.o.B Featuring Lil Wayne
Without You	David Guetta Featuring Usher
We Found Love	Rihanna Featuring Calvin Harris
You Make Me Feel...	Cobra Starship Featuring Sabi
Lighters	Bad Meets Evil Featuring Bruno Mars
You And I	Lady Gaga
Cheers (Drink To That)	Rihanna
In The Dark	Dev
Give Me Everything	Pitbull Featuring Ne-Yo, Afrojack & Nayer
Super Bass	Nicki Minaj
How To Love	Lil Wayne
Last Friday Night (T.G.I.F.)	Katy Perry
It Girl	Jason Derulo
Good Life	OneRepublic
Rolling In The Deep	Adele
Headlines	Drake
Tonight Tonight	Hot Chelle Rae
I Wanna Go	Britney Spears
God Gave Me You	Blake Shelton
Mr. Saxobeat	Alexandra Stan
She Will	Lil Wayne Featuring Drake
It Will Rain	Bruno Mars
If I Die Young	The Band Perry
Mr. Know It All	Kelly Clarkson
Take A Back Road	Rodney Atkins
Just A Kiss	Lady Antebellum
Nothing	The Script
I'm On One	DJ Khaled Featuring Drake, Rick Ross & Lil Wayne
Ni**as in Paris	Jay Z Kanye West
Marvin & Chardonnay	Big Sean Featuring Kanye West & Roscoe Dash
The Edge Of Glory	Lady Gaga
Crazy Girl	Eli Young Band
Barefoot Blue Jean Night	Jake Owen
Better With The Lights Off	New Boyz Feat. Chris Brown
Made In America	Toby Keith
Take Over Control	Afrojack Featuring Eva Simons
Fly	Nicki Minaj Featuring Rihanna
Motivation	Kelly Rowland Featuring Lil Wayne
Remind Me	Brad Paisley Duet With Carrie Underwood
Long Hot Summer	Keith Urban
Otis	Jay Z Kanye West Featuring Otis Redding
When We Stand Together	Nickelback
Dirt Road Anthem	Jason Aldean
You And Tequila	Kenny Chesney Featuring Grace Potter
Best Thing I Never Had	Beyonce
Easy	Rascal Flatts Featuring Natasha Bedingfield
Here For A Good Time	George Strait
Skyscraper	Demi Lovato
Love You Like A Love Song	Selena Gomez & The Scene
Marvins Room	Drake
We Owned The Night	Lady Antebellum
Paradise	Coldplay
Not Over You	Gavin DeGraw
Sparks Fly	Taylor Swift
Baggage Claim	Miranda Lambert
5 O'Clock	T-Pain Featuring Wiz Khalifa & Lily Allen
Keep Your Head Up	Andy Grammer
Country Must Be Country Wide	Brantley Gilbert
Just Fishin'	Trace Adkins
Tattoos On This Town	Jason Aldean
Work Out	J. Cole
The Adventures Of Rain Dance Maggie	Red Hot Chili Peppers
Brighter Than The Sun	Colbie Caillat
That Way	Wale Featuring Jeremih & Rick Ross
Quickie	Miguel
Pretty Girls	Iyaz Featuring Travie McCoy
Mrs. Right	Mindless Behavior Featuring Diggy
Rain Over Me	Pitbull Featuring Marc Anthony
Somewhere	Glee Cast
All Your Life	The Band Perry
Wet The Bed	Chris Brown Feat. Ludacris
Drink In My Hand	Eric Church
No Sleep	Wiz Khalifa
One More Drinkin' Song	Jerrod Niemann
Dedication To My Ex (Miss That)	Lloyd Featuring Andre 3000 & Lil Wayne
Sail	AWOLNATION
Fight For You	Jason Derulo
Got 2 Luv U	Sean Paul Featuring Alexis Jordan
Faster	Matt Nathanson
Let It Rain	David Nail Featuring Sarah Buxton
I Got You	Thompson Square
After Midnight	Blink-182
Love Don't Run	Steve Holy
I Don't Want This Night To End	Luke Bryan
Set Fire To The Rain	Adele
Every Teardrop Is A Waterfall	Coldplay
I Got Nothin'	Darius Rucker
Body 2 Body	Ace Hood Featuring Chris Brown
Fish	Craig Campbell
Gucci Gucci	Kreayshawn
Walk	Foo Fighters
Far Away	Tyga Featuring Chris Richardson
Keep Me In Mind	Zac Brown Band
Calling All The Monsters	China Anne McClain