Hello	Adele
Sorry	Justin Bieber
Love Yourself	Justin Bieber
Hotline Bling	Drake
What Do You Mean?	Justin Bieber
Stitches	Shawn Mendes
Same Old Love	Selena Gomez
Here	Alessia Cara
Stressed Out	twenty one pilots
Like I'm Gonna Lose You	Meghan Trainor Featuring John Legend
The Hills	The Weeknd
679	Fetty Wap Featuring Remy Boyz
Jumpman	Drake & Future
Ex's & Oh's	Elle King
White Iverson	Post Malone
On My Mind	Ellie Goulding
Antidote	Travis Scott
Wildest Dreams	Taylor Swift
Watch Me	Silento
In The Night	The Weeknd
Don't	Bryson Tiller
Roses	The Chainsmokers Featuring Rozes
Confident	Demi Lovato
Can't Feel My Face	The Weeknd
Die A Happy Man	Thomas Rhett
Perfect	One Direction
Trap Queen	Fetty Wap
I Know What You Did Last Summer	Shawn Mendes & Camila Cabello
Break Up In A Small Town	Sam Hunt
See You Again	Wiz Khalifa Featuring Charlie Puth
Hide Away	Daya
Say It	Tory Lanez
Lean On	Major Lazer & DJ Snake Featuring MO
My House	Flo Rida
Me, Myself & I	G-Eazy x Bebe Rexha
One Call Away	Charlie Puth
Hit The Quan	iLoveMemphis
Again	Fetty Wap
Focus	Ariana Grande
Locked Away	R. City Featuring Adam Levine
Cake By The Ocean	DNCE
Hands To Myself	Selena Gomez
No Role Modelz	J. Cole
Burning House	Cam
Where Ya At	Future Featuring Drake
Exchange	Bryson Tiller
When We Were Young	Adele
Down In The DM	Yo Gotti Featuring Nicki Minaj
Where Are U Now	Skrillex & Diplo With Justin Bieber
Stand By You	Rachel Platten
Do It Like Me	DLOW
Back Up	DeJ Loaf Featuring Big Sean
Home Alone Tonight	Luke Bryan Featuring Karen Fairchild
Adventure Of A Lifetime	Coldplay
Irresistible	Fall Out Boy
Gonna Know We Were Here	Jason Aldean
Big Rings	Drake & Future
I'll Show You	Justin Bieber
Back To Sleep	Chris Brown
New Americana	Halsey
Stay A Little Longer	Brothers Osborne
Good To Be Alive (Hallelujah)	Andy Grammer
WTF (Where They From)	Missy Elliott Featuring Pharrell Williams
I Got The Boy	Jana Kramer
I Love This Life	LOCASH
Right Hand	Drake
Best Friend	Young Thug
Used To Love You	Gwen Stefani
The Fix	Nelly Featuring Jeremih
Get Ugly	Jason Derulo
Come Get Her	Rae Sremmurd
Downtown	Macklemore & Ryan Lewis Featuring Eric Nally, Melle Mel, Kool Moe Dee & Grandmaster Caz
Dessert	Dawin
RGF Island	Fetty Wap
Gonna	Blake Shelton
Dibs	Kelsea Ballerini
Sorry Not Sorry	Bryson Tiller
$ave Dat Money	Lil Dicky Featuring Fetty Wap & Rich Homie Quan
Really Really	Kevin Gates
Hollow	Tori Kelly
Beautiful Drug	Zac Brown Band
Backroad Song	Granger Smith
Blase	Ty Dolla $ign Featuring Future & Rae Sremmurd
Top Of The World	Tim McGraw
Watch Out	2 Chainz
Purpose	Justin Bieber
Smoke Break	Carrie Underwood
Lay It All On Me	Rudimental Featuring Ed Sheeran
Liquor	Chris Brown
Let It Go	James Bay
Stick Talk	Future
Mr. Misunderstood	Eric Church
The Feeling	Justin Bieber Featuring Halsey
Break On Me.	Keith Urban
Zero	Chris Brown
Jugg	Fetty Wap Featuring Monty
You Should Be Here	Cole Swindell
We Went	Randy Houser
Confession	Florida Georgia Line
Play No Games	Big Sean Featuring Chris Brown & Ty Dolla $ign