Look What You Made Me Do	Taylor Swift
Bodak Yellow (Money Moves)	Cardi B
Despacito	Luis Fonsi & Daddy Yankee Featuring Justin Bieber
...Ready For It?	Taylor Swift
1-800-273-8255	Logic Featuring Alessia Cara & Khalid
Wild Thoughts	DJ Khaled Featuring Rihanna & Bryson Tiller
Attention	Charlie Puth
Believer	Imagine Dragons
Unforgettable	French Montana Featuring Swae Lee
There's Nothing Holdin' Me Back	Shawn Mendes
Rake It Up	Yo Gotti Featuring Nicki Minaj
Bank Account	21 Savage
Sorry Not Sorry	Demi Lovato
Strip That Down	Liam Payne Featuring Quavo
Slow Hands	Niall Horan
Shape Of You	Ed Sheeran
That's What I Like	Bruno Mars
Feel It Still	Portugal. The Man
XO TOUR Llif3	Lil Uzi Vert
Body Like A Back Road	Sam Hunt
Humble.	Kendrick Lamar
Mi Gente	J Balvin & Willy William Featuring Beyonce
Feels	Calvin Harris Featuring Pharrell Williams, Katy Perry & Big Sean
Congratulations	Post Malone Featuring Quavo
Something Just Like This	The Chainsmokers & Coldplay
Praying	Kesha
What Lovers Do	Maroon 5 Featuring SZA
Redbone	Childish Gambino
I'm The One	DJ Khaled Featuring Justin Bieber, Quavo, Chance The Rapper & Lil Wayne
Location	Khalid
I Get The Bag	Gucci Mane Featuring Migos
What About Us	P!nk
Young Dumb & Broke	Khalid
Stay	Zedd & Alessia Cara
Friends	Justin Bieber + BloodPop
Loyalty.	Kendrick Lamar Featuring Rihanna
Love Galore	SZA Featuring Travis Scott
Jocelyn Flores	XXXTENTACION
Say You Won't Let Go	James Arthur
What Ifs	Kane Brown Featuring Lauren Alaina
Small Town Boy	Dustin Lynch
No Promises	Cheat Codes Featuring Demi Lovato
Mask Off	Future
The Race	Tay-K
Thunder	Imagine Dragons
Transportin'	Kodak Black
The Way Life Goes	Lil Uzi Vert Featuring Nicki Minaj
When It Rains It Pours	Luke Combs
F**k Love	XXXTENTACION Featuring Trippie Redd
Do Re Mi	blackbear
It's A Vibe	2 Chainz Featuring Ty Dolla $ign, Trey Songz & Jhene Aiko
Crew	GoldLink Featuring Brent Faiyaz & Shy Glizzy
Roll In Peace	Kodak Black Featuring XXXTENTACION
Silence	Marshmello Featuring Khalid
Swish Swish	Katy Perry Featuring Nicki Minaj
Heartache On The Dance Floor	Jon Pardi
Sauce It Up	Lil Uzi Vert
Butterfly Effect	Travis Scott
No Such Thing As A Broken Heart	Old Dominion
Magnolia	Playboi Carti
The Weekend	SZA
New Rules	Dua Lipa
Unforgettable	Thomas Rhett
Back To You	Louis Tomlinson Featuring Bebe Rexha & Digital Farm Animals
Fetish	Selena Gomez Featuring Gucci Mane
Felices Los 4	Maluma
All The Pretty Girls	Kenny Chesney
Glorious	Macklemore Featuring Skylar Grey
B.E.D.	Jacquees
Everybody Dies In Their Nightmares	XXXTENTACION
Versace On The Floor	Bruno Mars
Whatever You Need	Meek Mill Featuring Chris Brown & Ty Dolla $ign
Havana	Camila Cabello Featuring Young Thug
Escapate Conmigo	Wisin Featuring Ozuna
Drinkin' Problem	Midland
They Don't Know	Jason Aldean
These Heaux	Bhad Bhabie
Every Little Thing	Carly Pearce
444+222	Lil Uzi Vert
Do I Make You Wanna	Billy Currington
Bad At Love	Halsey
More Girls Like You	Kip Moore
It Ain't My Fault	Brothers Osborne
Wish I Knew You	The Revivalists
Light It Up	Luke Bryan
Greatest Love Story	LANCO
My Girl	Dylan Scott
Most Girls	Hailee Steinfeld
Questions	Chris Brown
Relationship	Young Thug Featuring Future
Dark Queen	Lil Uzi Vert
I Could Use A Love Song	Maren Morris
X	Lil Uzi Vert
Neon Guts	Lil Uzi Vert Featuring Pharrell Williams
Fix A Drink	Chris Janson
Revenge	XXXTENTACION
Sky Walker	Miguel Featuring Travis Scott
Somebody Else Will	Justin Moore
Reminder	The Weeknd
No Fear	DeJ Loaf