Havana	Camila Cabello Featuring Young Thug
Perfect	Ed Sheeran
Rockstar	Post Malone Featuring 21 Savage
Finesse	Bruno Mars & Cardi B
Bad At Love	Halsey
Thunder	Imagine Dragons
No Limit	G-Eazy Featuring A$AP Rocky & Cardi B
New Rules	Dua Lipa
Too Good At Goodbyes	Sam Smith
MotorSport	Migos, Nicki Minaj & Cardi B
Gucci Gang	Lil Pump
Love.	Kendrick Lamar Featuring Zacari
Gummo	6ix9ine
Let You Down	NF
Him & I	G-Eazy & Halsey
Bartier Cardi	Cardi B Featuring 21 Savage
Meant To Be	Bebe Rexha & Florida Georgia Line
End Game	Taylor Swift Featuring Ed Sheeran & Future
Bodak Yellow (Money Moves)	Cardi B
I Fall Apart	Post Malone
Shape Of You	Ed Sheeran
How Long	Charlie Puth
Feel It Still	Portugal. The Man
I Get The Bag	Gucci Mane Featuring Migos
Wolves	Selena Gomez X Marshmello
Believer	Imagine Dragons
Plain Jane	A$AP Ferg Featuring Nicki Minaj
Sorry Not Sorry	Demi Lovato
Filthy	Justin Timberlake
Never Be The Same	Camila Cabello
What Lovers Do	Maroon 5 Featuring SZA
Young Dumb & Broke	Khalid
Sky Walker	Miguel Featuring Travis Scott
River	Eminem Featuring Ed Sheeran
Marry Me	Thomas Rhett
Roll In Peace	Kodak Black Featuring XXXTENTACION
The Way Life Goes	Lil Uzi Vert Featuring Nicki Minaj
Bank Account	21 Savage
Mi Gente	J Balvin & Willy William Featuring Beyonce
Lemon	N*E*R*D & Rihanna
Lights Down Low	MAX Featuring gnash
Let Me Go	Hailee Steinfeld & Alesso Featuring Florida Georgia Line & Watt
Ric Flair Drip	Offset & Metro Boomin
Attention	Charlie Puth
1-800-273-8255	Logic Featuring Alessia Cara & Khalid
The Weekend	SZA
The Champion	Carrie Underwood Featuring Ludacris
Unforgettable	French Montana Featuring Swae Lee
Yours	Russell Dickerson
Silence	Marshmello Featuring Khalid
Pills And Automobiles	Chris Brown Featuring Yo Gotti, A Boogie Wit da Hoodie & Kodak Black
Like I Loved You	Brett Young
All The Stars	Kendrick Lamar & SZA
Good Old Days	Macklemore Featuring Kesha
Nowadays	Lil Skies Featuring Landon Cube
Round Here Buzz	Eric Church
Echame La Culpa	Luis Fonsi & Demi Lovato
This Is Me	Keala Settle & The Greatest Showman Ensemble
Written In The Sand	Old Dominion
Stir Fry	Migos
Losing Sleep	Chris Young
Rubbin Off The Paint	YBN Nahmir
Codeine Dreaming	Kodak Black Featuring Lil Wayne
KEKE	6ix9ine, Fetty Wap & A Boogie Wit da Hoodie
Greatest Love Story	LANCO
Pick It Up	Famous Dex Featuring A$AP Rocky
La Modelo	Ozuna x Cardi B
You Broke Up With Me	Walker Hayes
Red Roses	Lil Skies Featuring Landon Cube
Rewrite The Stars	Zac Efron & Zendaya
Outside Today	YoungBoy Never Broke Again
Tell Me You Love Me	Demi Lovato
Kooda	6ix9ine
Candy Paint	Post Malone
Betrayed	Lil Xan
Heaven	Kane Brown
One Foot	WALK THE MOON
No Smoke	YoungBoy Never Broke Again
MIC Drop	BTS Featuring Desiigner
My My My!	Troye Sivan
Best Friend	Sofi Tukker Featuring NERVO, The Knocks & Alisa Ueno
I'll Name The Dogs	Blake Shelton
Five More Minutes	Scotty McCreery
Tequila	Dan + Shay
Legends	Kelsea Ballerini
Ice Tray	Quavo & Lil Yachty
Corazon	Maluma X Nego do Borel
All On Me	Devin Dawson
The Greatest Show	Hugh Jackman, Keala Settle, Zac Efron, Zendaya & The Greatest Showman Ensemble
My Dawg	Lil Baby
King's Dead	Jay Rock, Kendrick Lamar, Future & James Blake
IDGAF	Dua Lipa
Mayores	Becky G Featuring Bad Bunny
Broken Halos	Chris Stapleton
Krippy Kush	Farruko, Nicki Minaj, Bad Bunny, 21 Savage & Rvssian
...Ready For It?	Taylor Swift
Never Enough	Loren Allred
El Bano	Enrique Iglesias Featuring Bad Bunny
Beautiful Trauma	P!nk
Female	Keith Urban