Old Town Road	Lil Nas X Featuring Billy Ray Cyrus
ME!	Taylor Swift Featuring Brendon Urie
Wow.	Post Malone
Sucker	Jonas Brothers
Sunflower (Spider-Man: Into The Spider-Verse)	Post Malone & Swae Lee
7 Rings	Ariana Grande
Without Me	Halsey
Dancing With A Stranger	Sam Smith & Normani
Bad Guy	Billie Eilish
Talk	Khalid
Sweet But Psycho	Ava Max
Middle Child	J. Cole
Break Up With Your Girlfriend, I'm Bored	Ariana Grande
Happier	Marshmello & Bastille
Shallow	Lady Gaga & Bradley Cooper
Going Bad	Meek Mill Featuring Drake
Eastside	benny blanco, Halsey & Khalid
High Hopes	Panic! At The Disco
Please Me	Cardi B & Bruno Mars
Better	Khalid
Girls Like You	Maroon 5 Featuring Cardi B
A Lot	21 Savage
Pure Water	Mustard & Migos
Sicko Mode	Travis Scott
Thotiana	Blueface
Be Alright	Dean Lewis
Suge	DaBaby
Beautiful Crazy	Luke Combs
Look Back At It	A Boogie Wit da Hoodie
Act Up	City Girls
Here With Me	Marshmello Featuring CHVRCHES
Envy Me	Calboy
Whiskey Glasses	Morgan Wallen
God's Country	Blake Shelton
Con Calma	Daddy Yankee & Katy Perry Featuring Snow
Close To Me	Ellie Goulding X Diplo Featuring Swae Lee
Drip Too Hard	Lil Baby & Gunna
Eyes On You	Chase Rice
When The Party's Over	Billie Eilish
Boy With Luv	BTS Featuring Halsey
Earth	Lil Dicky
Sanguine Paradise	Lil Uzi Vert
You Say	Lauren Daigle
Murder On My Mind	YNW Melly
Bury A Friend	Billie Eilish
Good As You	Kane Brown
Clout	Offset Featuring Cardi B
Thank U, Next	Ariana Grande
Walk Me Home	P!nk
Youngblood	5 Seconds Of Summer
Pop Out	Polo G Featuring Lil Tjay
Who Do You Love	The Chainsmokers Featuring 5 Seconds Of Summer
Look What God Gave Her	Thomas Rhett
Here Tonight	Brett Young
Baby Shark	Pinkfong
Close Friends	Lil Baby
Worth It	YK Osiris
Swervin	A Boogie Wit da Hoodie Featuring 6ix9ine
Night Shift	Jon Pardi
Love Ain't	Eli Young Band
Rumor	Lee Brice
Miss Me More	Kelsea Ballerini
Racks In The Middle	Nipsey Hussle Featuring Roddy Ricch & Hit-Boy
Make It Sweet	Old Dominion
Before I Let Go	Beyonce
Hey Look Ma, I Made It	Panic! At The Disco
Floating	ScHoolboy Q Featuring 21 Savage
Robbery	Juice WRLD
Baila Baila Baila	Ozuna x Daddy Yankee x J Balvin x Farruko x Anuel AA
Big Ole Freak	Megan Thee Stallion
Don't Call Me Up	Mabel
Cool	Jonas Brothers
Calma	Pedro Capo X Farruko
Girls Need Love	Summer Walker X Drake
GIRL	Maren Morris
Mixed Personalities	YNW Melly Featuring Kanye West
That's A Rack	Lil Uzi Vert
I've Been Waiting	Lil Peep & iLoveMakonnen Featuring Fall Out Boy
Wish You Were Gay	Billie Eilish
You Should See Me In A Crown	Billie Eilish
Put A Date On It	Yo Gotti Featuring Lil Baby
Talk You Out Of It	Florida Georgia Line
I'm So Tired...	Lauv & Troye Sivan
On My Way To You	Cody Johnson
CHopstix	ScHoolboy Q + Travis Scott
Shotta Flow	NLE Choppa
Shot Clock	Ella Mai
Ocean Eyes	Billie Eilish
Secreto	Anuel AA & Karol G
Light It Up	Marshmello, Tyga & Chris Brown
Love Someone	Brett Eldredge
Power Is Power	SZA, The Weeknd & Travis Scott
Faucet Failure	Ski Mask The Slump God
Knockin' Boots	Luke Bryan
Numb Numb Juice	ScHoolboy Q
Love Me Anyway	P!nk Featuring Chris Stapleton
24/7	Meek Mill Featuring Ella Mai
Stop Snitching	YG
SOS	Avicii Featuring Aloe Blacc
Kill This Love	BLACKPINK