Old Town Road	Lil Nas X Featuring Billy Ray Cyrus
Bad Guy	Billie Eilish
I Don't Care	Ed Sheeran & Justin Bieber
Senorita	Shawn Mendes & Camila Cabello
Talk	Khalid
Truth Hurts	Lizzo
Goodbyes	Post Malone Featuring Young Thug
Sucker	Jonas Brothers
Sunflower (Spider-Man: Into The Spider-Verse)	Post Malone & Swae Lee
No Guidance	Chris Brown Featuring Drake
Suge	DaBaby
Money In The Grave	Drake Featuring Rick Ross
If I Can't Have You	Shawn Mendes
Wow.	Post Malone
You Need To Calm Down	Taylor Swift
Hey Look Ma, I Made It	Panic! At The Disco
Dancing With A Stranger	Sam Smith & Normani
The Git Up	Blanco Brown
Beautiful People	Ed Sheeran Featuring Khalid
God's Country	Blake Shelton
Without Me	Halsey
Pop Out	Polo G Featuring Lil Tjay
Ran$om	Lil Tecca
Beer Never Broke My Heart	Luke Combs
Cross Me	Ed Sheeran Featuring Chance The Rapper & PnB Rock
Someone You Loved	Lewis Capaldi
Happier	Marshmello & Bastille
The London	Young Thug, J. Cole & Travis Scott
Panini	Lil Nas X
7 Rings	Ariana Grande
Sweet But Psycho	Ava Max
Never Really Over	Katy Perry
Whiskey Glasses	Morgan Wallen
Speechless	Dan + Shay
High Hopes	Panic! At The Disco
Shotta Flow	NLE Choppa
Antisocial	Ed Sheeran & Travis Scott
Act Up	City Girls
Rumor	Lee Brice
Middle Child	J. Cole
Knockin' Boots	Luke Bryan
Going Bad	Meek Mill Featuring Drake
Some Of It	Eric Church
Better	Khalid
Pure Water	Mustard & Migos
Con Calma	Daddy Yankee & Katy Perry Featuring Snow
My Type	Saweetie
Shallow	Lady Gaga & Bradley Cooper
Sicko Mode	Travis Scott
Clout	Offset Featuring Cardi B
All To Myself	Dan + Shay
GIRL	Maren Morris
South Of The Border	Ed Sheeran Featuring Camila Cabello & Cardi B
Go Loko	YG, Tyga & Jon Z
ME!	Taylor Swift Featuring Brendon Urie
Just Us	DJ Khaled Featuring SZA
Remember The Name	Ed Sheeran Featuring Eminem & 50 Cent
Worth It	YK Osiris
Nightmare	Halsey
Rodeo	Lil Nas X & Cardi B Or Nas
Cash Shit	Megan Thee Stallion Featuring DaBaby
Rearview Town	Jason Aldean
Easier	5 Seconds Of Summer
Press	Cardi B
EARFQUAKE	Tyler, The Creator
Under The Sun	Dreamville Featuring J. Cole, Lute & DaBaby
Callaita	Bad Bunny & Tainy
Call You Mine	The Chainsmokers & Bebe Rexha
Walk Me Home	P!nk
Talk You Out Of It	Florida Georgia Line
Look What God Gave Her	Thomas Rhett
Trampoline	SHAED
BLOW	Ed Sheeran With Chris Stapleton & Bruno Mars
It's You	Ali Gatie
Cool	Jonas Brothers
Lalala	Y2K & bbno$
The Ones That Didn't Make It Back Home	Justin Moore
Raised On Country	Chris Young
La La Land	Bryce Vine Featuring YG
Soltera	Lunay, Daddy Yankee & Bad Bunny
24/7	Meek Mill Featuring Ella Mai
One Thing Right	Marshmello & Kane Brown
Tip Of My Tongue	Kenny Chesney
Otro Trago	Sech, Darell, Nicky Jam, Ozuna & Anuel AA
Before I Let Go	Beyonce
Calma	Pedro Capo X Farruko
Only Human	Jonas Brothers
No Me Conoce	Jhay Cortez, J Balvin & Bad Bunny
Baguettes In The Face	Mustard featuring NAV, Playboi Carti & A Boogie Wit da Hoodie
Like A Rodeo	Kane Brown
I Don't Know About You	Chris Lane
Time	NF
Tap	NAV Featuring Meek Mill
Love Ain't	Eli Young Band
Sanguine Paradise	Lil Uzi Vert
Southbound	Carrie Underwood
Que Pretendes	J Balvin & Bad Bunny
Spirit	Beyonce
Best Part Of Me	Ed Sheeran Featuring YEBBA
Wake Up	Travis Scott